oo	□
o	○
vv	、
v[	﹁
v]	﹂
v[[	﹃
v]]	﹄
c.	！
v.	！
s.	？
kaa	々
naa	々
o	〇
vu,	ゔ
erl	兀
yneu	嗀
ynou	嗀
e	一
ti	丁
c	七
le	丄
ti	丅
eny	万
vy	万
qx	丈
s	三
fe	上
fa	下
eri	丌
ba	不
kee	与
tly	丏
fkk	丐
ee	丑
me	且
bee	丕
jre	世
sl	世
kee	丘
poe	丘
enb	丙
en	丙
tnb	丙
weev	丞
wee	丞
kua	丟
ffe	丠
ene	両
enu	両
tne	両
tnu	両
kua	丢
eb	两
enbb	两
befe	並
be	並
bkj	並
boe	並
ii	丨
bii	个
si	个
bii	丫
yi	丫
ci	中
cj	中
zej	丮
zqj	丮
zqx	丮
fj	丰
fi	丱
cci	串
ccj	串
ffr	丳
rffr	丳
rfrr	丳
aa	丶
vv	丶
kaa	丸
za	丸
zx	丸
nae	丹
nle	丹
nlj	丹
ake	主
jaa	丼
enaa	丽
la	丽
pp	丿
xx	乂
rp	乃
nnn	久
nv	久
gnn	乆
lbn	乆
unn	乆
gl	乇
pua	么
wa	么
axx	义
bx	义
azn	之
az	之
vfe	乍
hj	乎
bzn	乏
paz	乏
pzn	乏
kep	乒
ktp	乒
pop	乒
kea	乓
poa	乓
gi	乔
gnr	乔
pdr	乔
gff	乖
gjjt	乗
grs	乗
grt	乗
gs	乗
gyys	乗
gffs	乘
gs	乘
zl	乙
zz	乙
cl	乜
yll	乜
k	九
vzl	乞
vzz	乞
al	也
ell	乢
wll	乣
uol	乨
zol	乩
gol	乱
ezl	乳
jdjl	乹
jll	乹
jdjz	乾
jvz	乾
esl	乿
nqil	亀
nqql	亀
nxl	亀
uiql	亀
uql	亀
jdgz	亁
etnl	亂
gol	亂
mcl	亃
mcsl	亃
yndl	亄
ynel	亄
ii	亅
wi	了
ui	予
eej	争
nej	争
jce	事
jcie	事
vej	事
r	二
rii	亍
uj	于
rkk	亏
ta	云
dee	互
rri	亓
w	五
jj	井
ere	亗
ede	亘
dae	亙
ede	亙
zfr	些
oe	亜
uuur	亝
efe	亞
oe	亞
koue	亟
woue	亟
bll	亡
fl	亡
lrl	亢
lrz	亢
lri	亣
lxx	交
lha	亥
lhn	亥
lfa	亦
lhw	亨
low	亨
lwi	亨
lhz	享
loz	享
lzj	享
los	京
lsa	京
lhnt	亭
lnt	亭
lont	亭
ltv	亭
lhnr	亮
lnr	亮
lonr	亮
lrv	亮
ldo	亯
lod	亯
lds	亰
lpde	亱
lpu	亱
lx	亱
ltn	亲
lgv	亳
lhng	亳
lng	亳
long	亳
looe	亶
loom	亶
llef	亷
llq	亷
lpef	亷
lpq	亷
lqn	亷
lqp	亷
lsnm	亹
bn	人
ae	亼
bee	亼
bll	亾
fl	亾
pjj	什
pre	仁
pdx	仂
pdy	仂
pti	仃
lbn	仄
pux	仅
ppa	仆
pkl	仇
pkx	仇
pkz	仇
pbn	仈
prl	仉
prz	仉
ayy	今
bri	介
brv	介
vr	介
bbn	仌
prp	仍
bbn	从
pua	仏
pzj	仔
pye	仕
pyv	仕
pal	他
pqx	仗
paa	付
pei	仙
bei	仚
pie	仜
bie	仝
pda	仞
pgj	仟
pgj	仠
pvz	仡
pax	代
api	令
ata	令
uba	以
ubn	以
u	以
psa	仦
fbn	仧
pse	仨
pfe	仩
plu	仮
psp	仯
pfp	仰
pay	仱
pci	仲
pcj	仲
pbl	仳
pue	仴
pwj	仵
psj	件
pbr	价
pgn	仸
ppd	仸
pfj	仹
bee	仺
pke	任
pke	仼
pbd	份
pfy	仿
pbu	伀
bze	企
pjn	伂
pln	伂
pui	伃
pqi	伄
pel	伅
pnm	伆
pru	伇
pha	伈
plr	伉
pex	伊
ppu	伋
prn	伋
pwe	伍
pju	伎
pad	伏
paq	伐
ptn	休
pki	伒
pba	伓
pnr	伔
pqn	伕
pxu	伖
bbb	众
pak	优
pfn	伙
ada	会
ad	会
bta	会
pkj	伜
pta	伝
pxp	伢
pyp	伢
pnb	伨
pnr	伨
pcn	伬
plw	伭
ppd	伯
pjo	估
pbs	伱
pcf	伲
psl	伳
pbj	伴
pfo	伵
pap	伶
pat	伶
piq	伷
pii	伸
piqi	伸
pme	伹
peo	伺
pyeo	伺
ppj	伻
pua	似
pub	似
pdo	伽
pbe	伾
pob	伿
pbo	佀
puo	佁
pez	佂
pqo	佃
pgo	佄
pqb	佅
pys	佅
pde	但
pnt	佇
pxn	佈
pyu	佉
ppx	佊
pdo	佋
pzf	佌
ple	位
pxe	低
pak	住
pxi	佐
pxo	佑
pcn	佒
pte	体
pzo	佔
pto	何
php	佖
pnf	佗
aba	佘
abn	佘
aes	佘
brs	佘
atn	余
bha	余
bhn	余
psn	佚
pvj	佛
pvf	作
pno	佝
prg	佞
ppb	佟
pns	你
pbe	佡
pff	佢
pnq	佣
pwa	佤
pfp	佧
pnv	佩
pren	佩
prtn	佩
poo	佪
ppo	佫
pypf	佬
pps	佭
pao	佮
pbh	佯
ptd	佰
pco	佲
ve	佳
prj	佴
pbk	併
pyo	佶
pdk	佷
pgo	佸
pnlp	佹
pnp	佹
pbk	佺
pra	佻
prbb	佻
plx	佼
pbi	佽
pri	佽
pbu	佾
pc	使
pjcx	使
pjc	使
pvx	使
pkr	侀
psr	侁
plg	侂
pos	侃
ppe	侄
plh	侅
ln	來
pen	侇
pjqb	侇
pcc	侈
pdrk	侉
pxk	侉
pser	侊
pdr	例
afd	侌
ayt	侌
pya	侍
pmn	侎
psb	侏
pss	侏
ppf	侐
pxe	侑
pxu	侑
png	侒
pej	侓
pus	侔
pri	侕
ptnr	侕
amj	侖
bfl	侖
pneo	侗
png	侘
pnd	侚
prb	供
pza	侜
pk	依
plk	依
pgo	侞
pxiz	侟
pgn	侠
pco	価
peny	侢
ptny	侢
poo	侣
pov	侣
pmv	侮
pvom	侮
fdv	侯
pfvd	侯
peo	侰
pok	侱
pfk	侲
pbby	侳
aer	侴
penu	侵
prx	侵
popo	侶
pov	侶
pcyo	侷
pono	侷
pde	侸
pkw	侹
peay	侺
pbor	侻
pypz	侾
ptqx	便
ptx	便
peg	俀
poed	俁
pogn	俁
pokd	俁
pes	係
pps	係
ps	係
poz	促
pz	促
pix	俄
pajw	俅
pna	俅
pat	俆
pbh	俆
pqk	俇
pso	俈
pwo	俉
phx	俊
pubp	俊
purp	俊
pocl	俋
poc	俋
pajq	俌
pij	俌
padk	俍
pan	俍
bbm	俎
psu	俏
phr	俐
ptj	俑
ptnq	俑
pnrr	俒
pesi	俓
psi	俓
pui	俓
puy	俓
pmr	俔
pnt	俕
pbo	俖
pbbo	俗
pwo	俗
pez	俘
pxxn	俙
pqe	俚
pdcr	俛
pel	俛
pncr	俛
piqk	俜
pqk	俜
pot	保
ai	俞
aur	俞
pan	俟
puvd	俟
pgn	俠
pio	信
pcj	俥
phu	俬
pipm	修
pp	修
pav	俯
plpa	俯
pho	俰
pmeb	俱
plxd	俲
prss	俳
paqq	俴
pkx	俴
phk	俵
pfsu	俶
pucl	俷
puc	俷
pfnq	俸
poe	俹
pdil	俺
pdql	俺
pxl	俺
ppq	俻
ptu	俼
pki	俽
pgv	俾
ppg	俾
ppqg	俾
pzr	俿
pek	倀
pbgg	倂
pbk	倂
ppgg	倂
ppbo	倃
pppo	倃
pxxu	倄
pxx	倄
pjj	倅
peb	倆
penb	倆
ptnb	倆
pncp	倇
pln	倈
ado	倉
bpl	倉
bii	個
pojo	個
po	個
vii	個
pnb	倌
plo	倍
pfb	倎
prob	倎
pipd	倏
pipf	倐
pmi	們
pmy	們
qm	們
ppr	倒
pff	倓
pcee	倔
pceu	倔
pge	倕
pgjy	倕
pybg	倖
pyj	倖
puu	倗
psno	倘
pd	候
pifd	候
pdto	倚
pvo	倚
pkb	倛
pno	倜
pnyo	倜
jbn	倝
jdjb	倝
plos	倞
pls	倞
prd	借
pve	倠
pdd	倡
pjez	倢
pjz	倢
pzez	倢
pfp	倣
ppv	倣
pje	値
pjl	値
pjme	値
pjml	値
pnbi	倥
pnri	倥
pbnl	倦
pbnp	倦
ppl	倦
pnrs	倧
pns	倧
pcjo	倨
phu	倩
pgr	倪
pam	倫
pbf	倫
pqj	倬
pzdj	倬
phg	倭
pqt	倮
ptbu	倯
pybp	倰
pyrp	倰
pyx	倰
pdb	倱
pcs	倲
pjqs	倲
pjce	倳
pve	倳
peaz	倵
pwe	倵
pmeb	倶
pdrs	倷
pet	倸
pmn	倸
pacb	倹
pac	倹
pje	值
pjl	值
pjme	值
pjml	值
prc	偀
peny	偁
pber	偂
pbi	偂
pfdg	偃
prd	偄
ptnd	偄
pgq	偅
pfnd	偆
pofu	假
pox	假
pdl	偈
pdnl	偈
pwj	偉
pwos	偉
ppcu	偊
pcbk	偋
pro	偌
prxo	偌
pdez	偍
pjn	偍
pqk	偎
pfm	偏
pllm	偐
plpm	偐
pwlm	偐
prc	偑
pdem	偒
pdvm	偒
pep	偒
pcp	偓
pok	偔
pook	偔
pbpd	偕
pho	偖
pyd	偖
pypd	偖
psm	偗
pooo	偘
plnn	偙
pjop	做
pjx	做
pgg	偛
plht	停
plnt	停
plot	停
pt	停
pffu	偝
pst	偞
ppdk	偟
pcg	偠
pkbl	偡
pklb	偡
pklr	偡
pkl	偡
pkrl	偡
phf	偢
pld	偣
pbe	偤
pew	健
pfbu	偦
pyzu	偦
pzft	偨
pnmb	偩
peoq	偪
pmia	偫
pnqh	偬
ptoh	偭
por	偮
plk	偯
plok	偯
pfdd	偰
phdd	偰
pkm	偱
pqh	偲
pdi	偳
per	偳
petr	偳
pmbr	側
pr	側
pzmb	偵
zm	偵
pqnu	偶
pu	偶
pai	偷
paur	偷
pai	偸
paur	偸
pipq	偹
ppbd	偺
pppd	偺
pmg	偻
pjz	偼
pzez	偼
pbwf	偽
pewf	偽
pwa	偽
pywf	偽
ppqu	傀
pva	傀
pgiu	傁
pgu	傁
pigu	傁
plzr	傂
phs	傃
paja	傅
pia	傅
prr	傇
pct	傈
pfka	傉
pje	傋
pjny	傋
pmf	傌
pgy	傍
plnf	傍
pjb	傎
pjmb	傎
pleo	傏
pcst	傑
pct	傑
tfa	傑
pewd	傒
pqn	傔
pnv	傕
pado	傖
pbp	傖
plwq	傗
bbbj	傘
bbj	傘
ppq	備
pqo	備
prlq	備
prpq	備
p	備
plxp	傚
pnbo	傛
pnw	傛
pewu	傜
puu	傜
puwu	傜
pdee	傝
pbhi	傞
pbki	傞
pneq	傢
pfnw	傣
pum	傪
puum	傪
pqs	傫
pev	催
pleq	傭
prfd	傮
prod	傮
ppa	傯
ppoh	傯
peuu	傰
pmiz	傱
phnp	傲
pyfp	傲
pcua	傳
pjqa	傳
pqa	傳
pxa	傳
pfoo	傴
pfx	傴
dz	債
phmb	債
paqs	傶
pvdm	傷
pvd	傷
pve	傷
pdxx	傸
pjxb	傸
pldr	傹
pja	傺
pjrs	傺
ppop	傻
pxfp	傻
pxup	傻
prc	傼
pldj	傽
pftb	傾
pft	傾
pezf	傿
pmh	僁
pmg	僂
prnq	僃
pcrs	僄
prc	僅
puv	僅
pux	僅
pcw	僆
peem	僇
pem	僇
pdfu	僈
pmx	僈
ae	僉
aoob	僉
oa	僉
pcdl	僊
pcdp	僊
payb	僋
pcp	僌
pgqd	働
pflb	僎
polb	僎
pncq	像
pnn	像
pbho	僐
pbko	僐
pedo	僑
pgi	僑
pgno	僑
pgnr	僑
pgo	僑
ppdo	僑
pceb	僓
pqa	僓
pbea	僔
pfb	僕
pfed	僕
ppa	僕
pvn	僕
pydo	僖
pyoo	僖
pffd	僗
psnp	僘
pka	僙
preb	僙
prtb	僙
pdbs	僚
pla	僚
pkbi	僛
pjd	僜
pczz	僝
pbwf	僞
pewf	僞
pmq	僠
pcuh	僡
pjqh	僡
penc	僢
pens	僢
pqnd	僣
poj	僤
pooj	僤
pqer	僥
pyr	僥
pyyr	僥
pgl	僦
plok	僦
plsk	僦
pbo	僧
pbqd	僧
pja	僨
pjrb	僨
pmu	僩
pmno	僪
poh	僫
pvf	僬
pkkd	僭
plq	僮
pmcs	僯
pmc	僯
jjb	僰
jnsb	僰
pfv	僱
pcm	僳
peqe	僵
pxl	僶
prst	僷
ptts	僸
pbr	價
pcmb	價
pco	價
pcol	僻
ppj	僻
pfd	僼
prod	僼
phfh	僽
penp	僾
phx	僾
pnjy	僿
pax	儀
pbki	儀
pbx	儀
pvm	儁
pvu	儁
pffk	儂
pnk	儂
prok	儂
pttk	儂
ploe	儃
plom	儃
ph	億
pldh	億
pzl	億
pzz	億
psnq	儅
pso	儅
pnx	儆
prnp	儆
pfek	儇
pon	儇
pad	儈
paqd	儈
pbt	儈
pac	儉
pae	儉
paob	儉
pase	儉
poa	儉
pttz	儊
pnli	儋
pvo	儋
ppdp	儌
ppop	儍
pxfp	儍
pjac	儎
pbv	儐
pnbb	儐
pncb	儐
pnkb	儐
pnpb	儐
pnsb	儐
pdwf	儑
pur	儒
putr	儒
pte	儓
pyop	儓
pfa	儔
pyya	儔
pwh	儕
pwr	儕
prf	儖
prvf	儖
pfvz	儗
pcnb	儘
peff	儘
pf	儘
prfc	儚
pvfc	儛
pvfs	儛
pnht	儜
pnt	儜
pfft	儝
prnt	儝
prx	儞
pkt	償
psnb	償
psnt	償
psfs	儠
psl	儠
psos	儠
pqqq	儡
pzqh	儢
pdrw	儤
pjm	儥
pxbd	儥
pyfb	儥
pym	儥
plbf	儦
pqab	儧
pqnb	儧
pkkb	儨
pmbe	儩
pmbm	儩
pak	優
ptdp	優
ptmp	優
pyx	優
plhq	儫
plnq	儫
ploq	儫
pqv	儫
pll	儭
pltr	儭
plhz	儮
pbnf	儯
prbf	儰
pref	儰
pryf	儰
pal	儱
plul	儱
pih	儲
piyd	儲
xm	儲
pnoa	儳
pln	儴
plok	儴
pipf	儵
pevo	儶
pla	儷
pllb	儷
pfc	儸
pfsv	儸
psrb	儹
prcv	儺
puv	儺
psnf	儻
poop	儼
pop	儼
pox	儼
pqqs	儽
pjck	儾
pvnk	儾
rl	儿
erl	兀
url	允
rrl	元
orl	兄
tl	充
trl	充
ra	兆
rbb	兆
xur	兇
srl	先
ser	光
bur	兊
jor	克
bor	兌
dcr	免
el	免
ncr	免
pcra	兎
idr	児
bor	兑
grl	兒
idr	兒
dcra	兔
eaa	兔
eav	兔
ncra	兔
pcra	兔
mer	兕
uer	兕
url	兕
lrur	兖
lur	兖
lbor	兗
lorv	兗
lor	兗
lror	兗
jorj	兙
snor	党
jorg	兛
fpdr	兜
pdfr	兜
jord	兝
jorm	兞
srsr	兟
fpdr	兠
pdfr	兠
jord	兡
jorr	兢
jorq	兣
serb	兤
serk	兤
bp	入
bll	兦
fl	兦
nbn	內
nbp	內
bke	全
bk	全
eba	兩
ebn	兩
ebp	兩
eb	兩
enbb	兩
tnbb	兩
ai	兪
aur	兪
b	八
bua	公
l	六
akk	兮
bkk	兮
rba	共
rb	共
kbn	兲
keb	兵
kv	兵
pob	兵
kba	其
meb	具
fba	典
rorb	典
beww	兹
rww	兹
beef	兼
qn	兼
bqrb	兾
ffqb	冀
ny	冂
nre	冄
nba	内
nbn	内
nle	円
xny	冇
nye	冉
nyj	冉
mj	冊
nne	冊
nrj	冊
noo	冋
mj	册
nne	册
eny	再
ey	再
tny	再
nbo	冏
nro	冏
due	冐
iqu	冑
dmo	冒
je	冓
jny	冓
dou	冔
ddcr	冕
del	冕
dncr	冕
drv	冕
ny	冖
nrl	冗
nrz	冗
kl	冘
nf	写
nke	写
nme	冝
nmn	冞
npdc	冟
npdf	冟
kc	冠
nrra	冠
nrq	冡
neqa	冢
neq	冢
nrq	冢
nru	冣
ndca	冤
nea	冤
nnca	冤
ndl	冥
nrru	冦
neoq	冨
nrdn	冪
pba	冬
pbe	冬
awn	冰
bwn	冰
bde	冱
bci	冲
bcj	冲
bjn	决
bxp	冴
byp	冴
bor	况
buo	冶
bap	冷
bat	冷
bbj	冸
baxx	冹
bax	冹
bsr	冼
bdr	冽
bao	冾
bjcs	凁
bvs	凁
bdcr	凂
bel	凂
bncr	凂
bat	凃
bbh	凃
bjeg	凄
bjg	凄
bojo	凅
bve	准
btbu	凇
bee	凈
bne	凈
blos	凉
bls	凉
bhu	凊
bno	凋
bnyo	凋
bybp	凌
byrp	凌
byx	凌
bcs	凍
bc	凍
bjqs	凍
bsv	凍
bae	凎
baqo	减
bko	减
bcy	凐
bfnd	凑
bfnn	凑
bfn	凑
bed	凒
bct	凓
bado	凔
bvj	凖
wvj	凖
bev	凗
bkbk	凘
bfyg	凙
bfy	凙
btts	凚
bloh	凛
blos	凛
bloh	凜
blos	凜
bfvz	凝
bz	凝
birf	凞
brof	凞
grof	凞
grpf	凞
rlv	几
rl	几
rz	几
prl	凡
prz	凡
raa	凡
prl	凢
prz	凢
arl	凣
arz	凣
rux	凤
crl	凥
crz	凥
rta	凨
red	凬
pkr	凭
rpdk	凰
edr	凱
eflr	凱
jdr	凳
bmfr	凴
ui	凵
xui	凶
ruo	凸
to	凸
meo	凹
ueo	凹
uo	凹
eei	出
eui	出
rei	出
kbbu	函
wbbu	函
wui	函
kouu	凾
wouu	凾
dp	刀
yee	刁
daa	刃
dax	刃
dnx	刄
dba	刅
bdp	分
cdp	切
xri	刈
vzr	刉
gri	刊
gri	刋
ari	刌
nmr	刎
kri	刏
naer	刐
nlr	刐
kri	刑
aqr	划
arv	划
ar	划
rrr	刓
jri	刔
ddd	刕
uri	刖
dri	列
wri	刘
vri	刜
vdp	初
mri	刞
dor	刟
mri	删
nner	删
oxr	刡
uor	刣
bri	判
odr	別
onr	別
yur	刦
yud	刧
nolr	刨
nri	刨
hri	利
mri	刪
nner	刪
nrr	刪
odr	别
onr	别
gor	刮
eder	刯
pri	到
jda	刱
jdb	刱
yyr	刲
drkr	刳
xri	刳
rtr	刴
rri	刵
snr	制
cnr	刷
bnd	券
xatr	刹
xtr	刹
jnsr	刺
jri	刺
jr	刺
lhr	刻
yudn	刼
rtr	剁
bqir	剃
bqpr	剃
tri	剃
esir	剄
sir	剄
uir	剄
uyr	剄
dri	剅
adur	剆
ari	剆
mbr	則
our	剈
bbyr	剉
sur	削
jorr	剋
jcsr	剌
vsr	剌
beur	前
bi	前
xatr	剎
xtr	剎
bkdn	剏
rdr	剒
hdd	剓
dnmr	剔
eri	剔
rssr	剕
lor	剖
aqar	剗
kri	剗
bkdb	剙
jcer	剚
ver	剚
nber	剛
nr	剛
nxr	剛
ncpr	剜
cewr	剝
cr	剝
ewr	剝
dtor	剞
vri	剞
uuur	剟
lhsr	剠
losr	剠
lsr	剠
ffr	剡
eqar	剢
acbr	剣
acr	剣
whr	剤
cewr	剥
ewr	剥
cjor	剧
flor	剨
hlor	剨
gffr	剩
gr	剩
bdp	剪
bdv	剪
beud	剪
lrur	剫
dri	剬
err	剬
etnr	剬
cpr	剭
onbr	剮
qor	剮
eoqr	副
vc	副
grsr	剰
gr	剰
gyyr	剰
nfor	割
nhor	割
nrv	割
raor	剳
ror	剳
edr	剴
ador	創
ar	創
bpr	創
ceqr	剶
eqr	剶
llr	剷
lpr	剷
lpsr	剷
wlr	剷
wlsr	剷
cuar	剸
jqur	剸
xri	剸
eebr	剹
emr	剹
qbpd	剺
yspd	剺
euur	剻
udmr	剼
umr	剼
uuur	剼
crsr	剽
foor	剾
fxr	剾
sqtr	剿
mnbr	劀
mnrr	劀
vfr	劁
lber	劂
aqr	劃
eqer	劃
er	劃
tqur	劃
zaor	劄
lber	劆
lqr	劆
cjor	劇
zeqr	劇
zri	劇
zr	劇
cold	劈
pdp	劈
pdx	劈
pdy	劈
ddar	劉
oar	劉
wri	劉
wrv	劉
adr	劊
aqdr	劊
atr	劊
btr	劊
ooor	劋
ecr	劌
zaqr	劌
zri	劌
acr	劍
aoor	劍
ari	劍
aser	劍
ori	劍
aood	劎
odp	劎
rvur	劐
whr	劑
wrr	劑
pmqr	劓
aood	劔
aoon	劔
aoox	劔
odn	劔
nobr	劖
srsr	劗
lttr	劘
ceqr	劙
cwfr	劚
dx	力
dy	力
dll	劜
udx	劝
udy	劝
dba	办
lrl	办
lyl	办
idx	功
idy	功
doo	加
sdx	劣
sdy	劣
ddd	劦
tdx	动
tdy	动
mdx	助
mdy	助
gud	努
yud	劫
nod	劬
dod	劭
snd	劮
rnd	劳
snd	労
bnd	劵
lxd	効
fkd	劻
yod	劼
lhd	劾
jzd	势
jord	勀
esid	勁
sid	勁
uid	勁
uyd	勁
sod	勂
jnzd	勃
vomd	勄
jcsd	勅
vsd	勅
tdx	勇
tdy	勇
tnqd	勇
tqd	勇
dcrd	勉
edx	勉
edy	勉
ncrd	勉
jord	勊
bnpd	勌
pdx	勌
pdy	勌
losd	勍
lsd	勍
ybyd	勎
ydx	勎
ydy	勎
yryd	勎
lod	勏
zfd	勐
ldx	勑
ldy	勑
rcd	勒
ry	勒
bpdd	勓
tohd	勔
gd	動
gqd	動
tdx	動
tdy	動
dmd	勖
dmd	勗
kdx	勘
kdy	勘
klbd	勘
klrd	勘
krld	勘
mpd	務
pdx	務
pdy	務
ombd	勛
ubnd	勝
ud	勝
use	勝
ffnd	勞
rnd	勞
snd	勞
rddd	募
eebd	勠
emd	勠
crsd	勡
jzd	勢
ybyd	勢
yd	勢
ykad	勢
yryd	勢
yzd	勢
hmbd	勣
rcd	勤
sqtd	勦
vdx	勧
vdy	勧
wvd	勧
smbd	勩
gdx	勪
gdy	勪
gnod	勪
pdod	勪
mqd	勫
lqd	勭
zdx	勮
zdy	勮
zeqd	勮
lood	勯
dddh	勰
rqnd	勱
gqdf	勲
gqfd	勲
gqdf	勳
gqfd	勳
zqhd	勴
fnd	勵
ld	勵
lend	勵
lrqd	勵
lvd	勵
ldx	勷
ldy	勷
lood	勷
rdx	勸
rdy	勸
rood	勸
udx	勸
udy	勸
vdx	勸
vdy	勸
naa	勺
nbe	勻
nre	勻
nkl	勼
nkx	勼
nkz	勼
nbn	勽
nua	勾
nmp	勿
nm	勿
nbe	匀
nbl	匃
nfl	匄
nl	包
nol	包
nqh	匆
nqx	匆
nxu	匈
npj	匉
nmn	匊
ni	匋
nwu	匋
najq	匍
nij	匍
ndil	匎
ndql	匎
nxl	匎
drkl	匏
drkn	匏
xnl	匏
xnol	匏
neoq	匐
nsq	匑
nrao	匒
nro	匒
nsoo	匔
flv	匕
fl	匕
pfl	化
ffl	北
dezf	匙
jfl	匙
fl	匚
fal	匜
fni	匝
fnj	匝
fie	匞
flr	匟
fki	匠
fkv	匠
fke	匡
fnm	匢
fqi	匣
fur	匥
fgn	匧
frss	匪
fs	匪
fck	匭
fwv	匯
wfl	匯
wfv	匯
foj	匰
fooj	匰
fceb	匱
fqa	匱
fdoo	匲
faob	匳
foa	匳
fzmr	匴
fyfb	匵
fym	匵
frvg	匶
fmmv	匷
fl	匸
frl	匹
fxx	区
fvde	医
fvd	医
fao	匼
fdg	匽
ffm	匾
fro	匿
frxo	匿
fooo	區
fv	區
fxx	區
j	十
gj	千
sj	卅
kjj	卆
xj	升
wj	午
jrj	卉
bj	半
jro	卋
fj	卌
kzj	卍
zkj	卍
zzj	卍
jdb	协
kzj	卐
zzj	卐
pgj	卑
pqg	卑
jjj	卒
qj	卓
zdj	卓
jdb	協
jddd	協
jq	協
bqj	单
oj	单
ooqj	单
jnbg	南
n	南
oj	単
ooqj	単
sqj	単
jaja	博
jia	博
pa	卜
re	卝
yze	卝
lpa	卞
opa	卟
zoo	占
fpa	卡
zof	卣
yyp	卦
rbn	卧
rpa	卧
pi	卩
fpi	卬
fpi	卭
ipi	卭
fpl	卮
dpi	卯
epi	印
nlp	危
npl	危
np	危
dop	卲
dup	即
gi	即
yup	却
dapa	卵
eppa	卵
fypa	卵
ccp	卶
bnp	卷
pl	卷
wzp	卸
pfp	卹
wep	卺
bbop	卻
wpi	卻
yup	卻
ernp	卼
adfp	卽
dup	卽
gi	卽
pdfp	卽
dadp	卿
ddup	卿
dgi	卿
tbwp	厀
twp	厀
lp	厂
lpl	厄
ldx	历
ldy	历
fny	厉
lvy	厉
lxp	厊
lyp	厊
lya	压
lxe	厎
lvf	厏
lwu	厒
lyy	厓
lpe	厔
lakm	厖
llj	厗
lqe	厘
lcj	厙
ldz	厚
lge	厜
lgjy	厜
lrd	厝
lrss	厞
lpds	原
ya	原
lmbr	厠
lhh	厤
lbei	厥
ltmp	厦
ljb	厧
ljmb	厧
lda	厨
ladk	厩
ldl	厩
lduk	厩
lpdk	厩
lrc	厪
lhnp	厫
lyfp	厫
ldpo	厬
lad	厭
ldud	厭
yn	厭
lkbk	厮
lsnp	厰
laob	厱
loa	厱
len	厲
lrqu	厲
lu	厲
lvy	厲
oolp	厳
ox	厳
slip	厳
ldui	厴
yqi	厴
ua	厶
xua	厷
kua	厹
dua	厺
yua	去
lyu	厾
zyu	厾
uds	叁
use	叁
udm	参
uds	参
ump	参
um	参
uuum	参
udm	參
uds	參
ump	參
um	參
uuum	參
use	叄
uuus	叄
ufa	叅
uha	叅
uuuf	叅
uuuh	叅
ux	又
uaa	叉
uax	叉
pux	及
rnn	及
rnx	及
xux	友
uux	双
lux	反
gux	収
gux	叐
pxu	叐
uuu	叒
fsu	叔
uuuu	叕
rux	取
enu	受
atu	叙
bhu	叙
offu	叚
ox	叚
blu	叛
nfu	叜
yupu	叝
giu	叟
gux	叟
uuum	叠
znbu	叡
zneu	叡
bbe	叢
febu	叢
fru	叢
oo	口
joo	古
noo	句
odx	另
ody	另
odp	叨
opi	叩
oba	只
ogi	叫
doo	召
dv	召
obn	叭
oti	叮
too	可
to	可
uoo	台
uo	台
ofl	叱
cx	史
xoo	右
koo	叴
foo	叵
ojj	叶
okk	号
eo	司
yeo	司
oux	叹
odx	叻
ody	叻
ode	叼
oye	叼
oie	叿
ogj	吀
ouj	吁
ovz	吃
poo	各
ooo	吅
owa	吆
ozj	吇
aoo	合
yoo	吉
oni	吊
onj	吊
oaa	吋
neo	同
coo	名
foo	后
jcx	吏
vxx	吏
oye	吐
pno	向
ogl	吒
ofa	吓
ooo	吕
opo	吕
owj	吘
ofn	吙
oex	吚
eoo	君
oee	吜
woo	吝
wov	吝
edo	吞
gno	吞
pdo	吞
oay	吟
oad	吠
obl	吡
hoo	吢
oha	吣
obr	吤
oba	吥
boo	否
ocl	吧
oel	吨
obd	吩
opf	吪
ayo	含
oki	听
olr	吭
our	吮
foo	启
oxu	吰
oju	吱
oqi	吲
oed	吳
ogn	吳
okd	吳
okeb	吳
oed	吴
ogn	吴
okd	吴
osp	吵
onb	吶
ojn	吷
opu	吸
orn	吸
oin	吹
oru	吺
onm	吻
ozl	吼
osj	吽
woo	吾
soo	吿
oxp	呀
oyp	呀
onb	呁
onr	呁
opo	呂
olp	呃
rjo	呄
owx	呅
otn	呆
otv	呆
woo	呇
oke	呈
okeb	呉
oneb	呉
soo	告
oqn	呋
odj	呌
ota	呍
ocn	呎
oxj	呏
onb	呐
gno	呑
pdo	呑
oda	呔
opx	呚
olw	呟
ote	呠
otj	呠
oox	呡
ocf	呢
oom	呣
oap	呤
oat	呤
ony	呥
owd	呦
oxe	呧
no	周
nyo	周
ors	呩
oor	呪
ozo	呫
ofo	呬
osl	呭
opj	呯
zfo	呰
oga	呱
ogn	呱
ozf	呲
oqb	味
oys	味
ono	呴
oto	呵
ogu	呶
oqi	呷
obe	呸
osn	呹
ook	呺
oii	呻
oiqi	呻
ohj	呼
aop	命
ode	呾
oyu	呿
ome	咀
ogo	咁
ofn	咂
oee	咄
oeu	咄
loo	咅
onl	咆
onol	咆
ohp	咇
ovj	咈
ocn	咉
ohn	咊
ovf	咋
hoo	和
ouo	咍
pbo	咎
ppo	咎
oun	咏
opa	咐
ojt	咑
oor	咒
owa	咓
ofp	咔
ojo	咕
odo	咖
oxn	咘
opb	咚
ogg	咞
okj	咞
otd	咟
orj	咠
orj	咡
ok	咢
oork	咢
oser	咣
ong	咤
ope	咥
oen	咦
ojqb	咦
odr	咧
bio	咨
rio	咨
obh	咩
omn	咪
cbv	咫
cnob	咫
olx	咬
oyo	咭
osb	咮
oss	咮
opo	咯
ond	咰
opm	咱
obed	咲
obgn	咲
ogn	咲
olh	咳
olf	咴
oxf	咴
odrk	咵
oxk	咵
ogo	咶
ora	咷
orbb	咷
aqpo	咸
aqvo	咸
ko	咸
ong	咹
oede	咺
opt	咻
qoo	咼
ood	咽
oypf	咾
ope	咿
lkn	哀
lk	哀
lok	哀
ooo	品
ov	品
oco	哂
oneo	哃
orb	哄
onxu	哅
occ	哆
oyy	哇
oao	哈
jaqo	哉
oxe	哊
oxu	哊
olk	哌
opno	响
orx	哎
odk	哏
ovs	哖
ous	哞
oso	哠
omb	員
okr	哢
oakm	哤
toto	哥
tt	哥
oix	哦
oyf	哧
osu	哨
oqe	哩
oeb	哪
ooz	哫
ooad	哭
oypz	哮
omr	哯
ons	哰
ojnz	哱
jko	哲
ojk	哳
oadk	哴
oan	哴
oodr	哵
oonr	哵
org	哶
orj	哶
oea	哷
oua	哷
oeg	哸
oez	哹
oajq	哺
oij	哺
odg	哻
olhw	哼
olow	哼
olw	哼
otqx	哽
otx	哽
doto	哿
ohr	唀
oio	唁
obbo	唂
owo	唂
one	唃
omb	唄
oayo	唅
ohx	唆
oubp	唆
ourp	唆
fko	唇
oocl	唈
ooc	唈
oan	唉
ouvd	唉
ogn	唊
oat	唋
obh	唋
opzw	唌
onrr	唍
ohr	唎
oxxn	唏
leo	唐
obby	唑
oeo	唒
ocj	唓
owo	唔
oyz	唗
louo	唘
oqf	唙
oenu	唚
orx	唚
ows	唦
odup	唧
ogi	唧
ohg	唩
ofnq	唪
oae	唫
or	唬
ozrv	唬
ozr	唬
okb	唭
voo	售
ove	唯
ocnr	唰
odd	唱
ogr	唲
ofad	唳
obkr	唴
odil	唵
odql	唵
oxl	唵
ord	唶
otu	唷
oayh	唸
ofbb	唹
ofb	唺
orob	唺
oln	唻
olg	唼
oge	唾
ogjy	唾
onmh	唿
olyy	啀
ono	啁
onyo	啁
ozu	啃
oeqa	啄
oqj	啅
ozdj	啅
lnbo	商
lnro	商
xo	商
oybg	啈
oyj	啈
ott	啉
obto	啊
oh	啊
oto	啊
oet	啋
omn	啋
onbi	啌
onri	啌
olhz	啍
oloz	啍
olz	啍
wwo	啎
moo	問
ojj	啐
ojez	啑
ojz	啑
ozez	啑
ocee	啒
oceu	啒
fop	啓
fpo	啓
faqo	啔
oni	啕
onwu	啕
off	啖
ong	啗
oncp	啘
zfoo	啙
zofo	啙
oloo	啚
ouuu	啜
oho	啝
oefe	啞
ooe	啞
foo	啟
fop	啟
fpo	啟
orss	啡
oeb	啢
oenb	啢
owzp	啣
opg	啤
opqg	啤
obgo	啥
obo	啥
ojl	啦
ohu	啨
ojpd	啪
owp	啵
onez	啶
onz	啶
oab	啷
oadb	啷
odem	啺
odvm	啺
oep	啺
lnno	啻
olnn	啼
oaor	啽
ohf	啾
okbl	啿
oklb	啿
oklr	啿
okl	啿
okrl	啿
onpo	喀
oqnu	喁
oqk	喂
ojng	喃
onj	喃
onv	喃
bhbo	善
bhro	善
bkbo	善
bkro	善
bv	善
odl	喅
yoyo	喆
yyoo	喆
ojcr	喇
ovsr	喇
obpd	喈
opfd	喉
oaqo	喊
oko	喊
ost	喋
ooyy	喌
ozft	喍
oonb	喎
oqo	喎
oro	喏
orxo	喏
old	喑
opbd	喒
oppd	喒
ocg	喓
ocp	喔
otoh	喕
otjo	喖
onc	喗
odi	喘
oer	喘
oetr	喘
oceq	喙
onc	喚
onfb	喚
onnd	喚
oegu	喛
oex	喛
ydo	喜
yobo	喜
yoro	喜
odl	喝
odnl	喝
oadp	喞
odup	喞
ogi	喞
opdp	喞
oqu	喟
ogq	喠
owj	喡
owos	喡
ogg	喢
onof	喣
opdk	喤
olru	喥
oooe	喦
onee	喧
one	喧
olnr	喨
olor	喨
oai	喩
oaur	喩
jbk	喪
jkv	喪
jook	喪
wkn	喪
ofdd	喫
ohdd	喫
edoo	喬
giv	喬
gi	喬
gnoo	喬
gnr	喬
gov	喬
go	喬
pdoo	喬
olpm	喭
owlm	喭
bqj	單
oj	單
ooqj	單
odjr	喯
olq	喱
osna	喲
otde	喳
otm	喳
oaqg	喴
orq	喵
oai	喻
oaur	喻
ltn	喿
ooot	喿
yneu	嗀
ynou	嗀
olzr	嗁
oewu	嗂
ouu	嗂
ouwu	嗂
olho	嗃
olno	嗃
oloo	嗃
oqo	嗃
otmp	嗄
opmd	嗅
oado	嗆
obp	嗆
woo	嗇
osoc	嗈
osol	嗈
ohs	嗉
oimb	嗊
oddu	嗋
obef	嗌
oye	嗌
obeu	嗍
omf	嗎
orbt	嗏
onfo	嗐
onho	嗐
oce	嗑
oyuf	嗑
orao	嗒
oro	嗒
ouut	嗓
ojb	嗔
ojmb	嗔
ofka	嗕
ogiu	嗖
ogu	嗖
oqu	嗗
ogy	嗙
olnf	嗙
owf	嗚
oqn	嗛
oypd	嗜
oeot	嗝
obhi	嗟
obki	嗟
obue	嗡
odf	嗢
oobf	嗢
ome	嗣
omyo	嗣
onro	嗣
oec	嗤
oeec	嗤
opdj	嗥
ojns	嗦
doam	嗧
owvm	嗨
osmb	嗩
oodh	嗯
obxc	嗲
obj	嗶
oqjq	嗶
oqj	嗶
ohnp	嗷
oyfp	嗷
hnpo	嗸
yfpo	嗸
ocw	嗹
oev	嗺
olrf	嗻
ordd	嗼
ojci	嗽
ovsi	嗽
ofvd	嗾
oayb	嗿
olno	嘀
oxo	嘀
oaqs	嘁
oogo	嘂
ooyo	嘂
oleq	嘃
ont	嘄
oadk	嘅
odfk	嘅
odl	嘅
oduk	嘅
opdk	嘅
orc	嘆
oux	嘆
oum	嘇
ouum	嘇
orfd	嘈
orod	嘈
yddo	嘉
yobo	嘉
yoro	嘉
yov	嘉
yq	嘉
oxxp	嘋
oypp	嘋
ocrs	嘌
omg	嘍
otmq	嘎
joou	嘏
joo	嘏
oeem	嘐
oem	嘐
ozh	嘑
offe	嘒
ooae	嘓
ooh	嘓
ooka	嘓
ofoo	嘔
ofx	嘔
oezf	嘕
ohmb	嘖
snod	嘗
snt	嘗
ozfe	嘘
oltt	嘛
ogc	嘜
ogp	嘜
olc	嘜
olp	嘜
ond	嘝
orcd	嘞
ohb	嘟
oypb	嘟
onhe	嘧
oeh	嘨
oemr	嘨
oerm	嘨
oaj	嘩
opfj	嘩
orjq	嘩
ofmb	嘪
oma	嘪
ojf	嘫
onbf	嘫
ouaf	嘫
odeu	嘬
odru	嘬
oydm	嘭
offd	嘮
ornd	嘮
oeh	嘯
orl	嘰
orz	嘰
owb	嘰
owwb	嘰
ocpu	嘱
ojdu	嘲
oju	嘲
ou	嘲
oceb	嘳
oqa	嘳
ozfn	嘴
oyr	嘵
oyyr	嘵
okbk	嘶
opmj	嘷
oek	嘸
ogl	嘸
ovff	嘸
odbs	嘹
ola	嘹
ogi	嘺
ogno	嘺
ogo	嘺
opdo	嘺
oydo	嘻
oyoo	嘻
ooj	嘽
oooj	嘽
ocdj	嘾
oxj	嘾
oqf	嘿
oflb	噀
oolb	噀
ooh	噁
obea	噂
ofds	噄
ohds	噄
obwf	噅
oewf	噅
owa	噅
oywf	噅
okkd	噆
olq	噇
ogl	噈
olok	噈
olsk	噈
oirp	噉
otrp	噉
omno	噊
olhp	噋
olop	噋
olzp	噋
obo	噌
obqd	噌
ovf	噍
oynd	噎
oaoe	噏
ooio	噐
opdj	噑
omcs	噒
omc	噒
ozfe	噓
ojd	噔
okky	噖
ofb	噗
ofed	噗
ovn	噗
olbi	噘
oblu	噙
obl	噙
obwu	噙
oeia	噚
oae	噞
oaob	噞
ooa	噞
lpvo	噟
oybw	噠
oyw	噠
onli	噡
ovo	噡
opnd	噢
opob	噢
ofnc	噣
otts	噤
offk	噥
onk	噥
orok	噥
ozas	噦
orqu	噧
om	器
ooao	器
kooo	噩
oev	噩
oe	噩
tooe	噩
tool	噩
olt	噪
ooot	噪
oldh	噫
ozw	噬
opdp	噭
ofek	噮
oon	噮
oenp	噯
ohx	噯
olwv	噰
ozeq	噱
oznr	噱
ozn	噱
oad	噲
oaqd	噲
obt	噲
ozod	噳
ozol	噳
oja	噴
ojrb	噴
ordl	噶
ord	噶
oldi	噷
oel	噸
oetb	噸
oet	噸
ose	噹
osnq	噹
oso	噹
ydoe	噽
ydol	噽
yobe	噽
yobl	噽
yore	噽
yorl	噽
onbd	噾
onrd	噾
oeej	噿
onht	嚀
ont	嚀
oeev	嚁
orf	嚂
orvf	嚂
ofww	嚃
orvu	嚄
our	嚅
outr	嚅
orlo	嚆
orq	嚆
ofa	嚇
oyff	嚇
oy	嚇
oaa	嚉
ofa	嚉
ofea	嚉
opmr	嚊
owh	嚌
oeff	嚍
olhq	嚎
olnq	嚎
oloq	嚎
oqv	嚎
ojnz	嚏
osnd	嚐
onjs	嚓
ojnz	嚔
oufd	嚕
offh	嚖
ohhh	嚖
odrw	嚗
otdp	嚘
otmp	嚘
oyx	嚘
ozu	嚙
ooro	嚚
opdt	嚛
orn	嚛
owpt	嚛
oqfy	嚜
olk	嚝
olrb	嚝
yoyo	嚞
ohdw	嚟
oddr	嚠
ooar	嚠
orff	嚥
orof	嚥
old	嚦
olhz	嚦
ozqf	嚧
oakp	嚨
oal	嚨
olul	嚨
omdg	嚪
omng	嚪
oll	嚫
oltr	嚫
ozsb	嚬
ozst	嚬
ydoo	嚭
yobo	嚭
yoro	嚭
wabo	嚮
wado	嚮
xpno	嚮
ouv	嚯
lhzj	嚲
lhzo	嚲
lozj	嚲
lozo	嚲
lzoj	嚲
lzo	嚲
snso	嚳
efl	嚴
oolp	嚴
opp	嚴
ox	嚴
onoa	嚵
ombg	嚶
osg	嚶
oln	嚷
olok	嚷
ooto	嚻
oefa	嚼
ohnb	嚽
oyfb	嚽
ore	嚾
orov	嚾
occa	囀
ocja	囀
ocqa	囀
ocx	囀
orrr	囁
oruu	囁
ooto	囂
ojtv	囃
ocrk	囅
ooqk	囅
orqc	囆
ola	囇
ollb	囇
orft	囈
oryt	囈
orz	囈
ofc	囉
ofsv	囉
jcnk	囊
vkv	囊
vnok	囊
osrb	囋
oruh	囌
ydoo	囍
yobo	囍
yoro	囍
ocpu	囑
ocwc	囑
oc	囑
oxa	囑
orms	囒
orm	囒
ofdu	囓
ohdu	囓
ojck	囔
ovnk	囔
oo	囗
nol	囘
oov	囘
obn	囚
f	四
ozj	囝
ooo	回
oov	回
pox	囟
odn	因
od	因
ogx	囡
oaa	団
oel	囤
olr	囥
own	囦
obn	囧
orn	囧
ota	囩
poc	囪
poq	囪
onm	囫
ohe	囬
oov	囬
orr	园
opf	囮
oke	囯
otn	困
poc	囱
pop	囱
ojj	囲
obx	図
oby	囶
ory	囶
ohn	囷
oez	囸
oap	囹
oat	囹
ojo	固
oox	囻
ouo	囼
oka	国
oxe	囿
oxu	囿
obf	圀
orf	圀
oio	圁
oeq	圂
oajq	圃
oij	圃
owo	圄
tobg	圅
oam	圇
obnl	圈
obnp	圈
opl	圈
op	圈
oybg	圉
oyj	圉
ohu	圊
oaqe	國
ohe	國
oka	國
odi	圌
oer	圌
oetr	圌
ojj	圍
os	圍
owj	圍
owos	圍
oumb	圎
obnl	圏
opl	圏
ok	園
orr	園
oyok	園
ob	圓
oomb	圓
oce	圔
oyuf	圔
obx	圖
oojo	圖
oolo	圖
opb	圖
ot	圖
oujh	圗
oujo	圗
oulh	圗
oulo	圗
oaa	團
ocua	團
ojqa	團
oup	團
oxa	團
oceb	圚
oqa	圚
ofyg	圛
ofy	圛
ofek	圜
oon	圜
oiss	圝
olf	圝
osis	圝
oist	圞
osit	圞
yev	土
ye	土
yv	土
yll	圠
yaa	圡
yae	圡
yti	圢
uye	圣
ypa	圤
xiy	在
xy	在
yuj	圩
yvz	圪
yrk	圬
yye	圭
yfl	圮
yol	圯
yal	地
gye	圱
ygj	圲
ysi	圳
yna	圴
yfe	圵
dye	圶
yki	圻
dye	圼
ynm	圽
ypu	圾
yrn	圾
ybr	圿
yze	址
yxx	坁
ylu	坂
yrr	坃
yru	坄
yay	坅
ypx	坆
ynb	均
ynr	均
ynr	坈
yel	坉
yfy	坊
ybd	坋
bdy	坌
ynae	坍
ynl	坍
yin	坎
yba	坏
bby	坐
ylr	坑
bye	坒
jye	坓
wye	坔
eye	坕
rry	坖
yjn	块
yde	坘
ywx	坟
ypx	坡
ybj	坢
sny	坣
yii	坤
yiqi	坤
yme	坥
yde	坦
ylo	坧
ynf	坨
ygo	坩
ypj	坪
yzo	坫
ycf	坭
yuo	坮
ybe	坯
yno	坰
ycn	坱
yvj	坲
ywd	坳
yby	坴
ye	坴
yry	坴
yke	坵
ypo	坵
yom	坶
yto	坷
yno	坸
yxe	坻
yka	坼
yap	坽
yat	坽
ypa	坿
yhj	垀
yvd	垁
ge	垂
gjjy	垂
yle	垃
kry	型
yneo	垌
ypm	垍
ypo	垎
yej	垏
biy	垐
riy	垐
ycc	垑
uuuy	垒
ylh	垓
cye	垔
foy	垕
ypb	垖
yra	垗
yrbb	垗
ypad	垘
yser	垙
yyy	垚
yrt	垛
yrt	垜
ynlp	垝
ynp	垝
yng	垞
ybh	垟
ydk	垠
paqy	垡
yfo	垢
yede	垣
ype	垤
yao	垥
dky	垦
ypno	垧
yna	垨
ydrk	垮
yxk	垮
yng	垵
ylj	垶
ymr	垷
ynrr	垸
yfb	垹
yez	垺
ymb	垻
miry	垼
wky	垽
ydg	垾
ylu	垿
gffy	埀
yeay	埁
ytqx	埂
ytx	埂
yan	埃
yuvd	埃
ypf	埄
bfy	埅
yne	埆
ytj	埇
ytnq	埇
yhx	埈
yubp	埈
yurp	埈
ygn	埉
ewy	埊
yqe	埋
yadk	埌
yan	埌
you	埍
yaqn	城
yaqy	城
yay	城
ypzw	埏
yenu	埐
yrx	埐
jky	埑
yea	埒
yua	埒
yajq	埔
yij	埔
yok	埕
tty	埜
yayh	埝
ynez	埞
yaqe	域
yhe	域
ypbj	埠
yoe	埡
ybnl	埢
ybnp	埢
ypl	埢
yjj	埣
ypg	埤
ypqg	埤
yhu	埥
yncp	埦
ymeb	埧
yam	埨
yee	埩
yne	埩
ynbi	埪
ynri	埪
ycs	埬
yjqs	埬
yew	埭
yff	埮
ydil	埯
ydql	埯
yxl	埯
yet	埰
ymn	埰
yfsu	埱
yfnq	埲
ydg	埳
yng	埳
yje	埴
yjl	埴
yjme	埴
yjml	埴
yge	埵
ygjy	埵
ybyz	埶
yka	埶
yryz	埶
yza	埶
yzx	埶
jka	執
jzx	執
ybgz	執
yka	執
yza	執
yzx	執
yz	執
ydnm	埸
yep	埸
ylo	培
kby	基
ky	基
ylhz	埻
yloz	埻
ylz	埻
ydto	埼
yvo	埼
yej	埽
yenn	埽
ruy	埾
wcfy	埿
ycee	堀
yceu	堀
yqt	堁
snoy	堂
sy	堂
ffy	堃
ygr	堄
ruy	堅
yve	堆
rce	堇
ynbe	堈
ytu	堉
oye	堊
yuu	堋
yojo	堌
ydca	堍
ynca	堍
yybp	堎
yyrp	堎
yyx	堎
ylyy	堐
ynbt	堔
ynn	堔
ynrt	堔
ybny	堘
ycy	堙
ync	堚
yeoq	堛
ycs	堜
yjqs	堜
yqo	堝
yst	堞
yceq	堟
yeq	堟
ypfd	堠
poty	堡
ypot	堢
yqnu	堣
ydez	堤
yjn	堤
mpy	堥
ybpd	堦
yrd	堧
ytnd	堧
ydl	堨
ydnl	堨
yhde	堩
ykbl	堪
yklb	堪
yklr	堪
ykl	堪
ykrl	堪
yai	堬
yaur	堬
ypdk	堭
yok	堮
yook	堮
qer	堯
yrl	堯
yyyr	堯
yfdg	堰
jpu	報
ybgu	報
ypu	報
yu	報
dupy	堲
ycm	堳
ydem	場
ydvm	場
yep	場
yho	堵
yypd	堵
yxiu	堶
yld	堷
yrc	堸
ygq	堹
yqbr	堺
wey	堻
yyay	堼
yfez	堽
yfnd	堾
yaqo	堿
yko	堿
duky	塈
dye	塈
ybbu	塉
ybfu	塉
yfbu	塉
yrbu	塉
ywnu	塉
yjn	塊
ypqu	塊
ypru	塊
yva	塊
ffny	塋
ydee	塌
ubny	塍
ynbo	塎
ynw	塎
yed	塏
yhs	塐
beuy	塑
zy	塑
ydya	塒
yha	塒
yndl	塓
yrao	塔
yro	塔
ybue	塕
ygfs	塖
waty	塗
wbhy	塗
wyv	塗
yleo	塘
ylho	塙
ylno	塙
yloo	塙
yqo	塙
ynea	塚
yneq	塚
ynex	塚
yct	塛
ynrq	塜
ygy	塝
ylnf	塝
njy	塞
ny	塞
rcfy	塟
rdfy	塟
recy	塟
ypbw	塠
yfmb	塡
yjb	塡
yjmb	塡
ywf	塢
woky	塣
yomb	塤
yeot	塥
bcy	塦
yrbf	塨
yrbh	塨
yvof	塩
yeg	塪
yjb	填
yjmb	填
ydf	塭
yobf	塭
yddq	塯
yoq	塯
aduy	塱
auy	塱
yvdm	塲
yve	塲
ypfw	塳
yeuu	塴
lby	塵
sye	塵
ylb	塶
yzof	塷
yzox	塷
yfoo	塸
yfx	塸
cky	塹
ltty	塺
yrdd	塻
ycua	塼
yjqa	塼
yqa	塼
yxa	塼
ydxx	塽
yjxb	塽
lhzy	塾
lozy	塾
lzzy	塾
ymg	塿
ycws	墀
ydfu	墁
ymx	墁
ycrs	墂
yldr	境
yr	境
yaqs	墄
quy	墅
yfnn	墆
yldj	墇
ykbd	墈
ykd	墈
ykld	墈
ykrd	墈
yleq	墉
jzy	墊
ybgy	墊
ybyy	墊
yryy	墊
yzy	墊
yudm	墋
yum	墋
yuum	墋
ylrf	墌
adfy	墍
duky	墍
dye	墍
pdfy	墍
ylhb	墎
ylob	墎
ylzb	墎
geay	墏
guay	墏
yrc	墐
ylno	墑
yxo	墑
ylno	墒
yxo	墒
rddy	墓
ryv	墓
yev	墔
yezf	墕
yaoq	墖
ybo	増
ybqd	増
yjdz	墘
yjvz	墘
bbey	墜
bby	墜
by	墜
yyr	墝
yyyr	墝
ybo	增
ybqd	增
yzfe	墟
yoj	墠
yooj	墠
ybho	墡
ybko	墡
yfx	墢
yjqu	墢
yfb	墣
yfed	墣
yvn	墣
yceb	墤
yqa	墤
ylq	墥
ymq	墦
ygno	墧
ygo	墧
ypdo	墧
qfy	墨
ylhp	墩
ylop	墩
ylzp	墩
lhzy	墪
lozy	墪
lzpy	墪
ybea	墫
bcey	墬
yaf	墭
yaqf	墭
bxiy	墮
bxuy	墮
hxiy	墯
ycdj	墰
yxj	墰
yjd	墱
yvff	墲
yja	墳
yjrb	墳
ywx	墳
yka	墴
yreb	墴
yrtb	墴
yut	墵
yaj	墷
yrjq	墷
yrrj	墷
ypnd	墺
ypob	墺
ywoo	墻
cruy	墼
cury	墼
ypdp	墽
dky	墾
eqdy	墾
uqdy	墾
uy	墾
ycn	墿
yfyg	墿
yfy	墿
ycol	壀
ypj	壀
coly	壁
cy	壁
pye	壁
crby	壂
yeqe	壃
tmty	壄
lwvy	壅
sny	壆
yloe	壇
ylom	壇
yta	壇
yloh	壈
yzeq	壉
yzn	壉
yjfk	壊
wcky	壍
ygqf	壎
yrf	壏
yrvf	壏
rye	壐
znby	壑
zney	壑
znwy	壑
yrc	壒
yryf	壒
lduy	壓
lya	壓
ly	壓
yye	壓
yyya	壔
ylhq	壕
ylnq	壕
yloq	壕
yqv	壕
yur	壖
yutr	壖
qqqy	壘
qyv	壘
uuuy	壘
ylk	壙
ylp	壙
ylrb	壙
yzqf	壚
ymdg	壛
ymng	壛
ydut	壜
ycew	壝
yqw	壝
yba	壞
yk	壞
ylfk	壞
akpy	壟
aye	壟
luly	壟
yal	壟
yal	壠
ylul	壠
yld	壢
ylhz	壢
yrg	壣
yrwf	壣
yln	壤
ylok	壤
yre	壦
yrov	壦
yoop	壧
yop	壧
yox	壧
qqqy	壨
ymb	壩
yuru	壩
ye	士
kev	壬
ke	壬
biy	壮
gye	壮
gye	壯
ycp	声
yc	声
ynf	壱
ynr	売
yner	壳
ynr	壳
yde	壴
yobe	壴
yyy	壵
ynfe	壷
yno	壷
ynre	壷
axe	壹
ynd	壹
ynf	壹
ynee	壺
ynfe	壺
yno	壺
yfbu	壻
yyzu	壻
yno	壼
faa	壽
fav	壽
yav	壽
yyia	壽
ydff	壾
yobf	壾
ybea	壿
yfoo	夁
px	夂
rux	夃
wpx	夃
pba	处
pbn	处
ppa	处
psj	夅
pfj	夆
pmn	夈
lfp	変
lfu	変
px	夊
hx	夋
ubp	夋
urp	夋
ybp	夌
yrp	夌
yx	夌
vdp	复
vx	复
bbyp	夎
tmp	夏
nnbp	夐
nnxp	夐
nobp	夐
noxp	夐
tdzp	夒
tmzp	夒
tzdp	夒
tzmp	夒
beap	夔
bezp	夔
btmp	夔
btzp	夔
hzop	夔
hzpp	夔
rpmp	夔
rzpp	夔
ca	夕
cpa	外
cpl	夗
cpi	夘
rda	夙
cca	多
lpde	夜
lpu	夜
lx	夜
ccno	够
nocc	够
ccno	夠
ck	夠
nocc	夠
rfnc	夢
tc	夢
ttc	夢
tfnc	夣
cenb	夤
cen	夤
cna	夤
cneb	夤
qtcc	夥
kblc	夦
kcc	夦
klbc	夦
klrc	夦
krlc	夦
dn	大
edn	天
gnn	天
daa	太
qnn	夫
jnv	夬
jn	夬
gnn	夭
pdn	夭
cn	央
ddx	夯
ddy	夯
dri	夰
snn	失
djj	夲
bda	头
bdn	头
ddn	夶
en	夷
jqb	夷
drk	夸
xk	夸
dsi	夼
dta	夽
gn	夾
bdn	奀
diql	奄
dql	奄
xl	奄
ddp	奅
doi	奅
dto	奇
vo	奇
drs	奈
fnq	奉
lyyd	奊
yyld	奊
dqo	奋
zod	奌
dyy	奎
fned	奏
fngn	奏
fnpd	奏
fn	奏
ncn	奐
nfb	奐
nnbd	奐
nnrd	奐
nobb	奐
norb	奐
fdd	契
hdd	契
dlh	奒
dcc	奓
djr	奔
lfd	奕
deu	套
gyd	奘
ewd	奚
ddu	奛
rssd	奜
dno	奝
dnyo	奝
dve	奞
bed	奠
tmdr	奡
ddv	奢
dho	奢
dypd	奢
eddu	奣
gndu	奣
dtoh	奤
mpdd	奦
auv	奧
pned	奧
pnmd	奧
poeb	奧
pomb	奧
bied	奨
gcad	奨
gead	奨
guad	奨
dfoo	奩
dfx	奩
daa	奪
dva	奪
dwh	奫
gcad	奬
gead	奬
gnbd	奬
guad	奬
dtdd	奭
jtdb	奭
dqo	奮
dvq	奮
fffd	奰
issd	奱
sisd	奱
dhoj	奲
dho	奲
dypj	奲
dypo	奲
gx	女
gux	奴
gti	奵
grp	奶
ggj	奷
ggj	奸
gal	她
gnn	奺
ggx	奻
ggl	奼
gzj	好
gz	好
gei	奾
zgx	奿
flg	妀
gna	妁
goo	如
gfl	妃
fgx	妄
gie	妅
big	妆
ggx	妆
gkl	妉
gnr	妉
gke	妊
gjj	妌
gkj	妍
gbr	妎
gwx	妏
gbu	妐
gfp	妒
gju	妓
glr	妔
ggn	妖
gpd	妖
gay	妗
gta	妘
gsp	妙
gba	妚
eeg	妛
egx	妛
elg	妛
gjn	妜
ggx	妝
gee	妞
dgx	妟
gnb	妠
gki	妡
gbd	妢
gbl	妣
gui	妤
egx	妥
eg	妥
gfj	妦
grr	妧
gfy	妨
glo	妬
gaxu	妭
gaxx	妭
gax	妭
gcf	妮
giq	妯
gvf	妰
gdo	妱
gde	妲
gns	妳
cpg	妴
gak	妵
glw	妶
gsn	妷
gto	妸
gqb	妹
gys	妹
gqb	妺
gys	妺
jeg	妻
jgx	妻
ghp	妼
gii	妽
giqi	妽
lgx	妾
dog	妿
ghn	姀
gno	姁
gbz	姂
gpaz	姂
gpz	姂
gez	姃
gox	姄
gbj	姅
gom	姆
pag	姇
gap	姈
gat	姈
gjn	姉
gln	姉
gjp	姊
guo	始
gny	姌
gmj	姍
gnne	姍
gnr	姍
gcn	姎
ggo	姏
gme	姐
gjo	姑
gub	姒
gse	姓
hgx	委
zfg	姕
gff	姖
gmj	姗
gnne	姗
gbk	姘
gpk	姙
gra	姚
grbb	姚
gneo	姛
bkg	姜
gsb	姝
gss	姝
gyo	姞
glh	姟
gpno	姠
ggo	姡
guu	姢
glx	姣
gfo	姤
gypf	姥
ggg	姦
ggg	姧
gen	姨
gjqb	姨
gvs	姩
gpe	姪
gre	姫
gre	姬
dddg	姭
gede	姮
gser	姯
gnd	姰
gdrk	姱
gxk	姱
gng	姲
gco	姳
drg	姴
gren	姵
grtn	姵
gao	姶
gxe	姷
gxu	姷
ggg	姸
gkj	姸
gng	姹
gsr	姺
god	姻
gcc	姼
gnlp	姽
gnp	姽
gbk	姾
big	姿
rig	姿
gaqj	娀
gaqx	娀
ag	威
aqpg	威
aqvg	威
grb	娂
gyy	娃
mgx	娄
giqk	娉
gqk	娉
gmr	娊
gsu	娋
gqe	娌
gaqn	娍
gaqy	娍
gay	娍
gakm	娏
wsg	娑
gvom	娒
gcm	娓
gjor	娔
gjcs	娕
gvs	娕
goz	娖
gkw	娗
gadk	娘
gan	娘
gesi	娙
gsi	娙
gui	娙
guy	娙
gqd	娚
goed	娛
gogn	娛
gokb	娛
gokd	娛
gt	娛
geb	娜
gbo	娝
geg	娞
gou	娟
gfk	娠
gyh	娡
gayo	娢
gbqp	娣
gtp	娣
gyg	娤
gix	娥
gkeb	娦
gpob	娦
gdcr	娩
gel	娩
gncr	娩
gwo	娪
geaz	娬
gwe	娬
gan	娭
guvd	娭
gio	娮
gokb	娯
gonb	娯
goed	娱
gogn	娱
ghr	娳
gru	娵
rug	娶
gge	娷
ggjy	娷
gkb	娸
gqlw	娹
guuu	娺
gcs	娻
gjqs	娻
gdd	娼
gcew	娽
gew	娽
glyy	娾
btog	娿
gbto	婀
mgx	婁
gpdn	婂
gpj	婂
gnrs	婃
gns	婃
glo	婄
gnm	婅
wpg	婆
get	婇
gmn	婇
gybp	婈
gyrp	婈
gyx	婈
gncp	婉
ghk	婊
gzr	婋
gfsu	婌
gdto	婍
gvo	婍
gve	婎
gdca	婏
gea	婏
gnca	婏
gqt	婐
ghg	婑
gff	婒
rssg	婓
grss	婔
gjez	婕
gjz	婕
gzez	婕
ggnf	婖
ggnh	婖
gpdf	婖
gpdh	婖
ggr	婗
gbnp	婘
gpl	婘
gee	婙
gne	婙
gxd	婚
glos	婛
gls	婛
rug	婜
gnez	婝
gnz	婝
gybg	婞
gyj	婞
gojo	婟
gnb	婠
gln	婡
gpg	婢
gpqg	婢
ghi	婣
gno	婤
gnyo	婤
gqj	婥
gzdj	婥
geev	婦
gee	婦
gej	婦
genn	婦
ghu	婧
gam	婨
gelg	婩
ttg	婪
gdb	婫
gek	婬
goe	婭
gcjo	婮
enag	婯
lgx	婯
gfb	婰
grob	婰
qlwg	婱
gequ	婳
gbqj	婵
goj	婵
gooj	婵
glht	婷
glnt	婷
glot	婷
gtv	婷
gdem	婸
gdvm	婸
gep	婸
gcg	婹
gvx	婹
mpg	婺
gjng	婻
gro	婼
grxo	婼
gofu	婽
gox	婽
gai	婾
gaur	婾
gfbu	婿
gyzu	婿
gqnu	媀
gwj	媁
gwos	媁
glnn	媂
gmt	媃
gbkd	媄
gkbl	媅
gklb	媅
gklr	媅
gkl	媅
gkrl	媅
grd	媆
gtnd	媆
glt	媇
gnc	媈
gcp	媉
gber	媊
gbi	媊
gfnd	媋
grq	媌
gdmb	媍
gnmb	媍
gho	媎
gypd	媎
gdi	媏
ger	媏
getr	媏
rflg	媐
rolg	媐
ggq	媑
ggt	媒
gpdk	媓
gtoh	媔
gaor	媕
grc	媖
gnee	媗
gne	媗
gbpd	媘
gaqg	媙
gcm	媚
gegu	媛
gex	媛
gzmb	媜
hfg	媝
gdez	媞
gjn	媞
gst	媟
gxiu	媠
gcs	媡
gjqs	媡
gdm	媢
gwkt	媣
gqh	媤
gfm	媥
gqu	媦
gonb	媧
gqo	媧
gbe	媨
gfu	媩
gjou	媩
gdf	媪
gobf	媪
gjz	媫
gzez	媫
gpot	媬
gai	媮
gaur	媮
gbwf	媯
gewf	媯
gwa	媯
gywf	媯
gnee	媰
gewu	媱
guu	媱
guwu	媱
gpob	媲
gpmh	媳
gyok	媴
ubng	媵
grr	媶
gfka	媷
gec	媸
geec	媸
gddq	媹
goq	媹
geep	媺
gerp	媺
zrug	媻
gdf	媼
gobf	媼
gmf	媽
gm	媽
gje	媾
gjny	媾
gpqu	媿
gpru	媿
gva	媿
gfnh	嫀
gneq	嫁
ggiu	嫂
ggu	嫂
gjb	嫃
gjmb	嫃
glps	嫄
gya	嫄
gbhi	嫅
gbki	嫅
gnbo	嫆
gnw	嫆
gndl	嫇
ffng	嫈
glbd	嫉
glvd	嫉
ghs	嫊
gqbb	嫋
gqmm	嫋
gbef	嫌
gqn	嫌
geg	嫍
ggy	嫎
glnf	嫎
gab	嫏
gadb	嫏
gqdg	嫐
gfvh	嫕
gcrs	嫖
gfoo	嫗
gfx	嫗
gqs	嫘
gfvz	嫙
gdfu	嫚
gmx	嫚
fvdg	嫛
gldj	嫜
glew	嫝
gleq	嫞
gfro	嫟
qbpg	嫠
yspg	嫠
glno	嫡
gxo	嫡
qamg	嫢
qgx	嫢
qnmg	嫢
gezf	嫣
grc	嫤
gcua	嫥
gjqa	嫥
gqa	嫥
gxa	嫥
gsnn	嫦
ghmb	嫧
grc	嫨
gjcp	嫩
gvsp	嫩
geem	嫪
gem	嫪
grdd	嫫
glrf	嫬
gzh	嫭
gurk	嫮
hnpg	嫯
yfpg	嫯
gjci	嫰
gvsi	嫰
bgx	嫳
snsg	嫳
gjog	嫴
gjol	嫴
ggl	嫵
gvff	嫵
gvf	嫶
gbxu	嫷
gbho	嫸
gbko	嫸
gka	嫹
gmu	嫺
gmt	嫻
gqf	嫼
gdbs	嫽
gla	嫽
gmcs	嫾
gmc	嫾
geqe	嫿
gbwf	嬀
gewf	嬀
gjd	嬁
glad	嬂
mtg	嬃
mtmg	嬃
gynd	嬄
gaj	嬅
grjq	嬅
grrj	嬅
grrq	嬅
gaoe	嬆
gceb	嬇
gqa	嬇
gqer	嬈
gyr	嬈
gyyr	嬈
gydo	嬉
gyoo	嬉
rfog	嬊
rofg	嬊
gbqj	嬋
goj	嬋
gooj	嬋
gedo	嬌
ggi	嬌
ggno	嬌
ggnr	嬌
ggo	嬌
gpdo	嬌
geep	嬍
gekp	嬍
gdcs	嬎
ges	嬎
gncs	嬎
gmq	嬏
gac	嬐
gae	嬐
gaob	嬐
goa	嬐
gldh	嬑
gad	嬒
gaqd	嬒
gpdp	嬓
gdcs	嬔
geas	嬔
ges	嬔
gncs	嬔
gfyg	嬕
gfy	嬕
colg	嬖
pgx	嬖
gloe	嬗
glom	嬗
gbew	嬘
gwoo	嬙
glbf	嬚
glpq	嬚
glq	嬚
gfek	嬛
gon	嬛
ldig	嬜
gnlk	嬝
grgq	嬞
gbki	嬟
gbx	嬟
glt	嬠
goot	嬠
genp	嬡
ghx	嬡
gdjk	嬢
gln	嬢
glok	嬢
gnht	嬣
gnt	嬣
gltu	嬤
gltw	嬤
geev	嬥
gyya	嬦
geff	嬧
gbeh	嬨
glwh	嬨
grwh	嬨
gea	嬩
gbv	嬪
gncb	嬪
gnkb	嬪
gnpb	嬪
gnsb	嬪
gfft	嬫
grnt	嬫
gur	嬬
gutr	嬬
grx	嬭
ldug	嬮
ygx	嬮
gte	嬯
gyop	嬯
mbmg	嬰
sgx	嬰
wckg	嬱
qdgd	嬲
grvu	嬳
foua	嬴
fouz	嬴
fuga	嬴
fugz	嬴
gspn	嬵
gsp	嬵
gltu	嬷
gltw	嬷
gnii	嬸
gni	嬸
gnmq	嬸
gseb	嬹
gfrh	嬺
gyfb	嬻
gym	嬻
gddr	嬼
goar	嬼
gfid	嬽
gfil	嬽
gfld	嬽
gjcb	嬾
gvsb	嬾
grff	嬿
grof	嬿
gutm	孀
gzaf	孂
gzdf	孂
gln	孃
glok	孃
gmcs	孄
gmjs	孄
gmn	孄
gbbe	孅
gmbg	孆
gsg	孆
gvvu	孇
gevo	孈
gre	孉
grov	孉
glts	孊
gllb	孋
issg	孌
lfg	孌
sisg	孌
goop	孍
gox	孍
gcwc	孎
grms	孏
grm	孏
zj	子
wex	孑
zx	孑
wnx	孓
zx	孓
zll	孔
rzj	孕
zzj	孖
nzj	字
xiz	存
xz	存
ezj	孚
jnz	孛
zpx	孜
ypz	孝
zfe	孟
eoz	孠
yeoz	孠
znl	孢
znol	孢
hzj	季
zga	孤
zgn	孤
zg	孤
guz	孥
zlh	孩
lfz	孪
zes	孫
zps	孫
zsa	孫
bgz	孬
znrs	孮
zns	孮
lhzz	孰
loza	孰
lozx	孰
lozz	孰
lzz	孰
czzz	孱
zoe	孲
bewz	孳
lwlz	孳
rwwz	孳
zzzd	孴
dapz	孵
eppz	孵
fypz	孵
bewz	孶
rwwz	孶
qbpz	孷
yspz	孷
snz	學
colz	孹
pzj	孹
zur	孺
zutr	孺
zeff	孻
eabz	孼
epbz	孼
rpbz	孽
zmbg	孾
zsg	孾
issz	孿
lfz	孿
sisz	孿
ny	宀
nti	宁
nrl	宂
nfl	它
nkl	宄
nkx	宄
nkz	宄
ngl	宅
nqk	宆
nqy	宆
nuj	宇
naa	守
ngx	安
ng	安
ntn	宋
nrr	完
nla	宍
ngn	宎
npd	宎
nxu	宏
nml	宒
nhp	宓
nak	宔
nly	宔
nlo	宕
nqu	宖
nrs	宗
nsa	宗
ns	宗
nbo	官
niq	宙
nez	定
nz	定
ncp	宛
nme	宜
nka	宝
nbd	实
nfn	実
npo	客
cf	宣
nede	宣
nee	宣
npe	室
nxe	宥
nxu	宥
nre	宦
nrv	宦
nre	宧
nra	宨
nrbb	宨
noo	宫
nov	宫
naqn	宬
nay	宬
neo	宭
noo	宮
nopo	宮
nov	宮
nlj	宰
nfo	害
nho	害
ndg	宴
nsu	宵
neq	家
net	宷
nmn	宷
nfk	宸
nbbo	容
nwo	容
nube	宻
nrrg	宼
nptd	宿
net	寀
nmn	寀
njez	寁
njz	寁
nzez	寁
nfsu	寂
nuv	寂
ndca	寃
nea	寃
nnca	寃
ndto	寄
nvo	寄
na	寅
neqb	寅
ntqb	寅
nhpe	密
xe	密
nrru	寇
nhu	寈
nzmb	寊
njp	寋
fq	富
neoq	富
nhf	寍
ngeb	寎
nge	寎
ngqb	寐
ngys	寐
npeu	寑
njb	寒
nqnu	寓
ndez	寔
njn	寔
ntft	寕
nweu	寖
nwr	寖
nhpq	寗
nhpy	寗
njb	寘
njmb	寘
ngg	寙
nkwu	寚
nrmr	寛
nhfi	寜
nhft	寜
ndv	寞
nrdd	寞
nja	察
njrs	察
nmg	寠
ntdd	寡
ntmd	寡
ngeu	寢
ngr	寢
ngi	寣
ngwo	寤
neem	寥
nem	寥
nbd	實
nfn	實
noa	實
nomb	實
noxb	實
nhft	寧
nti	寧
njt	寨
nii	審
niqi	審
nmq	審
nbwf	寪
newf	寪
nwa	寪
nywf	寪
nf	寫
ngnf	寫
nke	寫
nrma	寬
nrmr	寬
ndbs	寮
nla	寮
nvm	寯
nvu	寯
nfek	寰
non	寰
ngpt	寱
nfvz	寲
nka	寳
nknb	寳
nkvb	寳
nakp	寵
nal	寵
nlul	寵
nka	寶
nknb	寶
nkvb	寶
nkwb	寶
nfd	寷
nffd	寷
aa	寸
uaa	对
yaa	寺
eaa	寽
waa	対
faa	寿
foa	尀
yya	封
ajna	尃
iaa	尃
saa	射
jora	尅
biea	将
gca	将
gea	将
gca	將
gea	將
gua	將
cua	專
jqua	專
qaa	專
xa	專
caa	尉
crsa	尉
bea	尊
eaa	尋
eioa	尋
yda	尌
yoba	尌
a	對
faa	對
feba	對
uaa	對
waa	對
btma	導
dh	導
hwa	導
ola	導
sa	小
snn	尐
sp	少
bsa	尒
nsa	尔
vsa	尔
rsa	尕
sdn	尖
sye	尘
sno	尙
sno	尚
sss	尛
dbds	尞
la	尞
dezs	尟
jsp	尟
kbls	尠
klbs	尠
klrs	尠
krls	尠
ksp	尠
kl	尢
akl	尤
kna	尥
akm	尨
kke	尪
erk	尫
rke	尫
erbr	尬
kbr	尬
knlp	尯
knp	尯
kgq	尰
gl	就
lhsk	就
losk	就
lsak	就
kqu	尳
errf	尶
errf	尷
krf	尷
krvf	尷
cp	尸
ex	尹
cnn	尺
ckl	尻
ckx	尻
ckz	尻
cfl	尼
cnb	尽
cml	尾
cwn	尿
cyo	局
ono	局
cbl	屁
cnb	屄
cjo	居
ciq	屆
cyu	屆
cqo	屇
cee	屈
ceu	屈
csl	屉
ciq	届
cpe	屋
con	屌
cdf	屍
cmn	屎
cbk	屏
cmiu	屐
csu	屑
cfk	屒
cmb	屓
kecf	屔
pocf	屔
crk	展
clj	屖
cmz	屘
cbto	屙
cbgg	屛
cbk	屛
cpgg	屛
cmis	屜
csl	屜
crss	屝
cpcu	属
cst	屟
cd	屠
cho	屠
cypd	屠
cmg	屡
cmg	屢
cmiz	屣
cbo	層
cbqd	層
cta	層
cg	履
cmip	履
cmiv	履
cpv	履
cvv	履
cmit	屧
cmig	屨
cmig	屩
cmio	屩
cnds	屪
cnl	屪
cggo	屫
cgg	屫
cgpo	屫
cc	屬
cpcu	屬
cwfc	屬
cmbb	屭
cmbs	屭
ej	屮
ex	屮
el	屯
ei	山
bei	屳
edx	屴
edy	屴
eie	屸
evz	屹
efl	屺
eda	屻
edn	屻
eer	屼
eei	屾
eei	岀
eue	岄
elu	岅
egn	岆
epd	岆
exp	岈
eyp	岈
enm	岉
cei	岊
cle	岊
epu	岋
ern	岋
epu	岌
ern	岌
ekj	岍
ebd	岎
err	岏
eju	岐
eay	岑
eay	岒
eki	岓
bde	岔
ebr	岕
evf	岝
evf	岞
ecn	岟
eff	岠
nbee	岡
nbe	岡
nbtu	岡
nxx	岡
eto	岢
eno	岣
enb	岤
epx	岥
ele	岦
edo	岧
eme	岨
elo	岩
evj	岪
eiq	岫
eqi	岬
eap	岭
eat	岭
enf	岮
ebe	岯
ewd	岰
paxe	岱
kee	岳
kei	岳
ktu	岳
poe	岳
eke	岴
epo	岴
ejo	岵
epd	岶
eox	岷
elg	岸
edo	岹
eap	岺
eat	岺
exe	岻
edp	峁
eao	峆
eao	峇
epo	峈
epo	峉
pbe	峊
end	峋
epe	峌
eej	峍
edk	峎
eri	峏
etnr	峏
elh	峐
ebk	峑
eneo	峒
een	峓
ejqb	峓
eypf	峔
eng	峖
enlp	峗
enp	峗
eede	峘
eya	峙
edy	峚
edr	峛
ebz	峜
eneo	峝
enlp	峞
enp	峞
exe	峟
exu	峟
egn	峡
eee	峥
ene	峥
lfe	峦
eix	峨
eix	峩
ebbo	峪
ewo	峪
exb	峫
eyb	峫
eajq	峬
eij	峬
esu	峭
eeo	峮
epf	峯
epf	峰
qee	峱
epip	峳
emr	峴
enxu	峵
nei	島
elj	峷
eaqn	峸
eay	峸
bhe	峹
etqx	峺
etx	峺
ehx	峻
eubp	峻
eurp	峻
ev	峻
egn	峽
ewo	峿
eadk	崀
ean	崀
eyi	崁
enbi	崆
enri	崆
enrs	崇
ens	崇
es	崇
nrse	崈
nse	崈
ewd	崉
ett	崊
eejq	崋
eerj	崋
eggq	崋
ejjq	崋
etjq	崋
ecjo	崌
eln	崍
edto	崎
evo	崎
exd	崏
edb	崐
edb	崑
ejj	崒
eojo	崓
eve	崔
elyy	崕
elyy	崖
enbe	崗
enx	崗
eam	崘
eam	崙
eybp	崚
eyrp	崚
eyx	崚
ecee	崛
eceu	崛
ege	崜
egjy	崜
egry	崜
ehu	崝
elhz	崞
eloz	崞
elz	崞
eae	崟
ecs	崠
ejqs	崠
ekbu	崡
ewbu	崡
ewu	崡
eee	崢
ene	崢
ehg	崣
exxu	崤
exx	崤
epg	崥
epqg	崥
edil	崦
edql	崦
exl	崦
etbu	崧
ejez	崨
ejz	崨
ezez	崨
euu	崩
ejj	崪
ecs	崬
ejqs	崬
eojo	崮
eae	崯
esq	崰
embr	崱
epdk	崲
eai	崳
eaur	崳
eaqg	崴
edem	崵
edvm	崵
eep	崵
eyya	崶
ebe	崷
eta	崸
etmb	崸
elnn	崹
efva	崺
emia	崻
edez	崼
ejn	崼
eqh	崽
ecg	崾
evx	崾
eok	崿
eook	崿
etak	嵀
ekbl	嵁
eklb	嵁
eklr	嵁
ekl	嵁
ekrl	嵁
emie	嵂
elpm	嵃
ewlm	嵃
ebkd	嵄
eaqo	嵅
eko	嵅
hake	嵆
hake	嵇
eegu	嵈
eex	嵈
elht	嵉
elnt	嵉
elot	嵉
egfs	嵊
ecm	嵋
egi	嵌
mpe	嵍
eqnu	嵎
exup	嵏
erc	嵐
erx	嵐
edl	嵑
ednl	嵑
oooe	嵒
eooo	嵓
exup	嵕
eaqs	嵗
ehd	嵙
bhee	嵞
eewd	嵠
eado	嵢
eleo	嵣
ffne	嵤
rne	嵤
ecst	嵥
ect	嵥
eed	嵦
eddq	嵧
eoq	嵧
ewf	嵨
elho	嵩
elno	嵩
eloo	嵩
eqo	嵩
ebew	嵫
elww	嵫
erww	嵫
epqu	嵬
epru	嵬
eva	嵬
egy	嵭
elnf	嵭
efmb	嵮
ejb	嵮
ejmb	嵮
ebhi	嵯
ebki	嵯
enbo	嵱
enw	嵱
epmt	嵲
emiz	嵷
emiz	嵸
eqoc	嵹
equc	嵹
eeem	嵺
eem	嵺
elew	嵻
elps	嵼
ewls	嵼
efnn	嵽
eudm	嵾
eum	嵾
euum	嵾
ettb	嵿
ett	嵿
eurk	嶀
emg	嶁
eldj	嶂
eck	嶃
eck	嶄
erfd	嶆
erod	嶆
efoo	嶇
efx	嶇
egea	嶈
egua	嶈
eov	嶉
ejv	嶊
enf	嶋
enf	嶌
eeed	嶍
elel	嶏
ebps	嶐
encq	嶑
enn	嶑
ebo	嶒
ebqd	嶒
emq	嶓
eai	嶔
evf	嶕
eaoe	嶖
effd	嶗
ernd	嶗
etaq	嶘
etk	嶘
emcs	嶙
emc	嶙
edbs	嶚
ela	嶚
edbs	嶛
ela	嶛
ekkd	嶜
ejd	嶝
bxie	嶞
ebea	嶟
egi	嶠
egno	嶠
egnr	嶠
ego	嶠
epdo	嶠
epdr	嶠
elbi	嶡
eyr	嶢
eyyr	嶢
evf	嶣
eqer	嶤
eyr	嶤
eyyr	嶤
enli	嶦
evo	嶦
ecn	嶧
efyg	嶧
efy	嶧
sne	嶨
effk	嶩
enk	嶩
erok	嶩
eefe	嶪
efel	嶪
efet	嶪
efs	嶪
efel	嶫
efet	嶫
efs	嶫
ebki	嶬
ebx	嶬
epbg	嶭
epbl	嶭
eae	嶮
eaob	嶮
eoa	嶮
eorq	嶯
ends	嶰
erdb	嶱
erdl	嶱
erd	嶱
evm	嶲
evu	嶲
eeqy	嶳
pnee	嶴
pnme	嶴
poee	嶴
pome	嶴
efrs	嶵
efvz	嶷
efft	嶸
ernt	嶸
efa	嶹
eyya	嶹
eapb	嶺
eapt	嶺
eap	嶺
eatb	嶺
eatt	嶺
eat	嶺
ejav	嶻
eea	嶼
eke	嶼
eqid	嶽
eeih	嶾
esvq	巀
elru	巁
evno	巂
eal	巃
elul	巃
eal	巄
elul	巄
effo	巆
ezdq	巇
ercm	巈
enoa	巉
embg	巊
esg	巊
epbe	巋
epbn	巋
ere	巋
eye	巋
eoop	巌
eox	巌
eslp	巌
ehgu	巍
ehgv	巍
ere	巏
erov	巏
elhx	巐
elnx	巐
elox	巐
eqdx	巐
esrb	巑
isse	巒
lfe	巒
sise	巒
efmb	巓
efmt	巓
ejbt	巓
ejmb	巓
ejmt	巓
tjbb	巓
ejbb	巔
ejbt	巔
ejmb	巔
ejmt	巔
ebeg	巕
erpg	巕
eoop	巖
eop	巖
eox	巖
eoop	巗
eox	巗
enad	巘
ezed	巘
sa	巛
si	巛
si	川
yyy	州
yy	州
fsl	巟
esi	巠
sie	巠
uie	巠
uye	巠
swn	巡
sqt	巢
sqt	巣
sl	巤
sobs	巤
soxs	巤
ie	工
xie	左
ikk	巧
ffe	巨
ffo	巨
wev	巫
we	巫
wv	巫
bhi	差
bkpi	差
vi	差
esis	巰
sits	巰
uits	巰
uyts	巰
fll	己
gg	己
fll	已
oll	巳
cll	巴
cl	巴
fcl	巵
dofl	巶
dool	巶
hl	巷
rbfl	巷
rbol	巷
rbp	巷
wefl	巹
weol	巹
wep	巹
flfb	巺
olob	巺
bnfl	巻
bnol	巻
flfb	巽
olob	巽
ni	巾
nj	巾
jni	巿
jnj	巿
eni	帀
enj	帀
tni	帀
tnj	帀
lni	市
lnj	市
ni	市
xni	布
xnj	布
nti	帄
npr	帆
nra	帆
ren	师
rtn	师
yrn	师
ytn	师
nbd	帉
ncl	帊
xni	帋
xnj	帋
xxn	希
nkl	帎
nnr	帎
gun	帑
paxn	帒
nqb	帓
nys	帓
npx	帔
npd	帕
nzo	帖
naxx	帗
nax	帗
nbn	帘
nrn	帘
nsn	帙
ej	帚
enn	帚
pdn	帛
pj	帛
lnn	帝
ntd	帞
lfn	帟
gni	帠
gnj	帠
nbk	帡
nao	帢
bnn	帣
gon	帤
pbn	帥
rni	帥
rnj	帥
ynj	帥
nbor	帨
nsu	帩
nfk	帪
pben	師
pbtn	師
ren	師
rtn	師
yen	師
yni	師
ytn	師
eon	帬
lrn	席
fbn	帮
snn	帯
rej	帰
renn	帰
yej	帰
yenn	帰
nbgg	帲
nbk	帲
npgg	帲
nek	帳
naqq	帴
nkx	帴
nncp	帵
fnn	帶
snn	帶
nve	帷
snon	常
sn	常
nlg	帹
nkb	帺
ndm	帽
nho	帾
nypd	帾
nzmb	幀
nta	幁
ntmb	幁
nddn	幂
nwj	幃
nwos	幃
ncp	幄
neoq	幅
nq	幅
ndl	幆
ndnl	幆
yyan	幇
ncbg	幈
ncbk	幈
ncpg	幈
ncpk	幈
nimb	幊
zrun	幋
ndsr	幌
neg	幍
nndl	幎
nneq	幏
npa	幒
npoh	幒
nudm	幓
num	幓
nuum	幓
ndfu	幔
nmx	幔
rddn	幕
rnv	幕
noae	幗
noh	幗
noka	幗
nhmb	幘
nrdd	幙
fbpn	幚
fbp	幚
nldj	幛
ndls	幜
noj	幝
nooj	幝
nfb	幞
nfed	幞
nvn	幞
nlad	幟
nob	幟
nek	幠
ngl	幠
nvff	幠
nmq	幡
nlq	幢
bnj	幣
pnj	幣
snsn	幣
snv	幣
coln	幦
pnj	幦
nlt	幧
noot	幧
nnli	幨
nvo	幨
nja	幩
njrb	幩
nrnq	幪
fbn	幫
hi	幫
yyan	幫
yyap	幫
nyya	幬
nrfa	幭
nrfb	幭
nrfe	幭
nrfv	幭
nlda	幮
nlya	幮
nrp	幯
nzdp	幯
nzg	幯
nzp	幯
nnfh	幰
nnhh	幰
gj	干
gv	干
pj	平
vsj	年
ggj	幵
kj	幵
bkj	并
bgg	幷
bkj	幷
pgpg	幷
ybg	幸
yj	幸
gj	幹
jbg	幹
jdjg	幹
jg	幹
wa	幺
wyy	幻
wdx	幼
wdy	幼
wiwu	幽
wwe	幽
gb	幾
wba	幾
wwab	幾
lka	广
lp	广
lua	广
lv	广
lfl	庀
lti	庁
lbn	庂
lua	広
lye	庄
lbl	庇
lay	庈
lel	庉
gtn	床
ltn	床
lju	庋
lxp	庌
lyp	庌
lki	庍
lui	序
lfp	庐
lya	庒
lxe	底
lnl	庖
lnol	庖
lzo	店
zo	店
lqi	庘
liq	庙
lqo	庙
leb	庚
len	庚
lzf	庛
lpa	府
lpb	庝
lbh	庠
llk	庡
lpe	庢
lra	庣
lrbb	庣
lya	庤
lpt	庥
lru	度
lbby	座
lyv	座
lypz	庨
lat	庩
lbh	庩
ljju	庪
lcj	庫
lakm	庬
lkw	庭
leo	庮
lajq	庯
lij	庯
lbk	庰
lybp	庱
lyrp	庱
lyx	庱
lln	庲
lpg	庳
lpqg	庳
lrd	庴
ldil	庵
ldql	庵
lxl	庵
lrf	庶
lew	康
lenq	庸
lrcn	庹
lbut	庺
lrbb	庻
lqnu	庽
lgb	庾
lrq	庿
lnfu	廀
lmbr	廁
ltm	廂
ldl	廄
lduk	廄
lduu	廄
lce	廅
lyuf	廅
lpqu	廆
lpru	廆
lva	廆
lddq	廇
loq	廇
ltmp	廈
lbef	廉
lpq	廉
lqn	廉
lab	廊
ladb	廊
lgiu	廋
lgu	廋
lkf	廌
lftb	廎
lft	廎
ladu	廏
lduu	廏
lpdu	廏
ladk	廐
ldl	廐
lduk	廐
lpdk	廐
lrc	廑
lhnp	廒
lyfp	廒
llhb	廓
llob	廓
llzb	廓
lmg	廔
lbat	廕
leem	廖
lem	廖
lfnn	廗
llb	廘
lqrb	廙
lda	廚
lyda	廚
lyoa	廚
lqby	廛
lqry	廛
lch	廜
lcyd	廜
lkbk	廝
lai	廞
liq	廟
ljdu	廟
lju	廟
lp	廠
lsnp	廠
lek	廡
lgl	廡
lvff	廡
laxu	廢
lfx	廢
ljqu	廢
lka	廣
lp	廣
lreb	廣
lua	廣
lad	廥
laqd	廥
lcog	廦
lcol	廦
lpj	廦
lwoo	廧
lnds	廨
lloh	廩
lloh	廪
llos	廪
lfp	廬
lzqf	廬
lmbg	廮
lsg	廮
lufh	廯
lrjh	廰
lrj	廰
lsov	廱
lllb	廲
lh	廳
lrj	廳
lrkh	廳
lrkj	廳
lti	廳
wn	廴
swn	廵
pzw	延
kwn	廷
kwv	廷
kw	廷
iqw	廸
ewn	建
oow	廻
cwn	廼
ohw	廽
oow	廽
rjv	廾
rj	廾
rov	廿
ro	廿
urj	弁
flr	异
trj	弃
krj	弄
kr	弄
bdr	弅
yur	弆
aor	弇
lfr	弈
brj	弊
snsr	弊
srv	弊
axx	弋
axe	弌
axr	弍
axs	弎
axi	式
xati	弑
xtai	弑
xati	弒
xiv	弒
xtai	弒
qk	弓
qij	弔
qii	引
vj	弗
qua	弘
bqi	弚
qal	弛
qcl	弝
qin	弞
bqip	弟
bqp	弟
tp	弟
qff	弡
qeu	弢
qpa	弣
qxe	弤
qns	弥
qvs	弥
qlw	弦
qga	弧
qgn	弧
qg	弧
qdo	弨
guq	弩
qrj	弭
bnq	弮
lfq	弯
qsu	弰
qbqb	弱
qb	弱
qmqm	弱
qou	弲
qesi	弳
qsi	弳
qui	弳
quy	弳
qlhz	弴
qloz	弴
qlz	弴
qek	張
qlos	弶
qls	弶
qoc	強
quc	強
quu	弸
qbqj	弹
qoj	弹
qooj	弹
qoc	强
quc	强
qeoq	弻
qtoq	弻
qtdq	弼
qoj	弾
qooj	弾
qsqj	弾
yneu	彀
ynqu	彀
feqd	彂
qqjq	彃
qqj	彃
qqrj	彃
qqrq	彃
qfoo	彄
qfx	彄
bqk	彆
bqy	彆
snsq	彆
qbqj	彈
qoj	彈
qooj	彈
qka	彉
qreb	彉
qeqe	彊
qfek	彋
qon	彋
qns	彌
qrx	彌
qlk	彍
qlrb	彍
issq	彎
lfq	彎
sisq	彎
qmmu	彏
ee	彐
cee	彑
ree	归
yee	归
see	当
so	当
cew	彔
cew	录
ewa	录
ewn	录
ceq	彖
ffe	彗
ceff	彘
cevf	彘
cent	彙
cnqt	彙
cent	彚
enqt	彚
cemr	彛
embr	彛
cemr	彝
emsr	彝
earu	彠
eiou	彠
mp	彡
kmp	形
wmp	彣
naem	彤
nlm	彤
llm	彥
lpm	彥
wlm	彥
llm	彦
lpm	彦
wlm	彦
afoe	彧
aqme	彧
aqoe	彧
aqom	彧
axme	彧
hmx	彧
em	彩
etm	彩
mmp	彩
zrm	彪
nmp	彫
nmv	彫
nyom	彫
ttm	彬
ydm	彭
ymv	彭
yobm	彭
nbbm	彮
nwm	彮
crsm	彯
ldjm	彰
lm	彰
dlom	影
dlsm	影
dm	影
llbm	彲
lmp	彲
mii	彳
mina	彴
mipu	彶
mirn	彶
mif	彷
mibu	彸
miru	役
mip	彼
mixe	彽
miap	彾
miat	彾
miv	彿
mvv	彿
miak	往
mk	往
miez	征
mim	徂
mis	徃
miuy	径
dc	待
miya	待
mic	徆
mind	徇
hn	很
midk	很
mibh	徉
mioo	徊
mie	律
foo	後
i	後
miwp	後
miok	徎
mizs	徏
miat	徐
mibh	徐
xh	徐
miei	徑
misi	徑
miui	徑
miuy	徑
miyz	徒
mzv	徒
mibz	従
mz	従
mins	徖
dd	得
mida	得
mirs	徘
mizz	徙
mido	徛
miv	徛
miso	徜
bbn	從
mibz	從
mz	從
mino	徟
min	徟
mil	徠
miwp	御
mpv	御
midz	徥
mij	徥
miou	徦
mio	徦
mifm	徧
mipk	徨
mivp	復
miv	復
vdp	復
vx	復
mikm	循
mixm	循
mm	循
miws	徫
miw	徫
mig	徬
milf	徬
miee	徭
mieu	徭
miue	徭
miuu	徭
miep	微
mirp	微
rz	微
mied	徯
mics	徲
mh	徳
mijh	徳
mij	徳
miep	徴
mikp	徴
kp	徵
miep	徵
mikp	徵
mib	徶
misp	徶
mh	德
mijh	德
mij	德
milq	徸
micd	徹
mitp	徹
mit	徹
miad	徻
mipp	徼
miep	徽
misp	徽
miep	徾
miip	徾
mia	徿
mill	徿
milk	忀
mil	忀
midw	忁
mimv	忂
ha	心
hpx	必
hp	必
hdx	忇
hdy	忇
hdp	忉
hti	忊
flh	忌
dah	忍
gha	忎
hgj	忏
fha	忐
fha	忑
axh	忒
hgj	忓
hvz	忔
hdn	忕
haa	忖
yha	志
fha	忘
hfl	忙
hal	忚
hra	忛
ia	応
lha	応
edf	忝
edh	忝
gnf	忝
gnh	忝
pdf	忝
pdh	忝
wha	忞
hwx	忟
cha	忠
hci	忡
hcj	忡
hpu	忣
hrn	忣
hwj	忤
kha	忥
hbr	忦
hak	忧
hrr	忨
buh	忩
hbu	忪
hjn	快
hui	忬
hlp	忭
hju	忮
hxx	忯
hkj	忰
hkl	忱
hnr	忱
hda	忲
hel	忳
hay	忴
ayh	念
hta	忶
hxu	忷
hee	忸
hke	忹
hin	忺
hki	忻
hlr	忼
nmh	忽
hkl	忾
hkz	忾
bdh	忿
hba	怀
hff	怇
hsl	怈
hnl	怉
hnol	怉
hdo	怊
hox	怋
hbe	怌
hvf	怍
vfh	怎
vh	怎
hcn	怏
hno	怐
hbj	怑
gh	怒
guh	怒
hgu	怓
hez	怔
hpd	怕
hxn	怖
hzo	怗
hjo	怙
hme	怚
hde	怛
hap	怜
hat	怜
qha	思
hiq	怞
uoh	怠
huo	怡
hsn	怢
snh	怣
pah	怤
neh	急
hpj	怦
hse	性
cph	怨
hcf	怩
hui	怪
huy	怪
hvj	怫
hfo	怬
hhp	怭
hwd	怮
hyu	怯
hlw	怰
nqh	怱
henb	怲
hen	怲
hor	怳
haqf	怴
haqi	怴
hat	怵
hpx	怶
ath	怷
pah	怹
hqb	怽
hys	怽
hcc	恀
pkh	恁
hnd	恂
hya	恃
hyo	恄
hypf	恅
hdae	恆
hede	恆
hev	恆
he	恆
hfk	恇
hfd	恉
hddd	恊
lfh	恋
hra	恌
hrbb	恌
hser	恍
hpe	恎
gzh	恏
ih	恐
irah	恐
izh	恐
hnlp	恑
hnp	恑
hdae	恒
hede	恒
hco	恓
hlx	恔
goh	恕
pa	恖
poxh	恖
hpt	恘
bkh	恙
yyh	恚
hoo	恛
haxi	恜
fdh	恝
hdh	恝
hen	恞
hjqb	恞
hnxu	恟
hxiy	恠
hxxu	恡
hlf	恢
hxf	恢
bih	恣
rih	恣
hpf	恤
rha	恥
rze	恥
hpno	恦
rha	恧
tnrh	恧
hdk	恨
odh	恩
hpo	恪
hneo	恫
hgo	恬
rbf	恭
rbh	恭
hbk	恮
pmh	息
hao	恰
hbk	恲
dkh	恳
ldh	恴
cha	恵
jqh	恵
hlxu	恼
hso	恼
hwu	恼
hrf	恾
tha	恿
tnqh	恿
wtnh	恿
htj	悀
htnq	悀
hou	悁
hot	悃
hsu	悄
hu	悄
hbor	悅
hf	悅
hrv	悅
hr	悅
bhh	悆
hbh	悇
haqr	悈
eth	悉
mha	悉
jkh	悊
hwo	悋
hbqp	悌
htp	悌
hdg	悍
hso	悎
qfh	悐
hocl	悒
hoc	悒
hmr	悓
hm	悔
hvom	悔
hxxn	悕
hjnz	悖
hdcr	悗
hel	悗
hncr	悗
fvdh	悘
hlhw	悙
hlow	悙
hlw	悙
hjcs	悚
hvs	悚
hhx	悛
hubp	悛
hurp	悛
hok	悜
hqe	悝
hokd	悞
hwo	悟
piph	悠
hrh	悡
hadk	悢
han	悢
cch	患
pa	悤
poch	悤
poph	悤
hbor	悦
hhr	悧
phv	您
pnsh	您
hso	悩
hsxu	悩
oha	悪
hnrs	悰
hns	悰
hrss	悱
qt	悲
rssh	悲
jha	悳
jmlh	悳
hjj	悴
hek	悵
mha	悶
mh	悶
hfad	悷
hhz	悸
nbh	悹
hnb	悺
hybg	悻
hyj	悻
hqj	悼
hzdj	悼
hjeg	悽
hjg	悽
hnbi	悾
hnri	悾
hgnf	悿
hgnh	悿
hpdf	悿
hpdh	悿
ham	惀
tkh	惁
hdb	惃
fsuh	惄
hhu	情
hno	惆
hnyo	惆
hlhz	惇
hloz	惇
hlz	惇
hqt	惈
wzoh	惉
hlos	惊
hls	惊
hncp	惋
ncph	惌
hae	惍
kbh	惎
htt	惏
haqe	惐
hhe	惐
aqoh	惑
hha	惑
hoh	惒
hbnl	惓
hbnp	惓
hpl	惓
hff	惔
hdnm	惕
hep	惕
denh	惖
dvmh	惖
eha	惖
hayh	惗
hnbf	惘
huuu	惙
hnmh	惚
hxd	惛
hrd	惜
hsno	惝
hki	惞
hve	惟
hv	惟
cha	惠
cuh	惠
jh	惠
jqh	惠
jquh	惠
efeh	惡
oha	惡
hhh	惢
snmh	惣
hqlw	惤
gbh	惥
hlzo	惦
hmb	惧
mieh	惩
jha	惪
jmeh	惪
hbqj	惮
hoj	惮
hooj	惮
hxiu	惰
hlxu	惱
hso	惱
hspo	惱
hspx	惱
hswu	惱
hsxu	惱
hsx	惱
hwu	惱
hnc	惲
th	想
tmh	想
hdi	惴
her	惴
hetr	惴
hst	惵
hpdk	惶
fndh	惷
hndz	惸
rm	惹
roh	惹
rxoh	惹
hds	惺
hmbr	惻
hfm	惼
hoxd	惽
hxup	惾
hdez	惿
hjn	惿
hhf	愀
hfh	愁
hnee	愃
hne	愃
hqk	愄
hrc	愅
miwh	愆
hwj	愇
hwos	愇
aha	愈
aurh	愈
hai	愉
haur	愉
heoq	愊
hegu	愋
hex	愋
hnnd	愌
hnob	愌
oxph	愍
hvdp	愎
hvx	愎
ldh	意
htoh	愐
htd	愑
htnd	愑
htqd	愑
hdl	愒
hdnl	愒
hdem	愓
hdvm	愓
hep	愓
hld	愔
hok	愕
hook	愕
hkbl	愖
hklb	愖
hklr	愖
hkl	愖
hkrl	愖
hnpo	愘
npoh	愙
qh	愚
qnuh	愚
enhp	愛
enxu	愛
hx	愛
hfg	愜
hfdg	愝
hrd	愞
htnd	愞
ah	感
aqph	感
aqvh	感
kha	感
hdf	愠
hobf	愠
hnqh	愡
hqh	愢
hff	愣
hpqu	愧
hva	愧
yneh	愨
ynrh	愨
himb	愩
homb	愪
hhs	愫
beuh	愬
hewu	愮
huu	愮
huwu	愮
hvu	愯
hdsr	愰
hlbd	愱
hqu	愲
mmh	愳
hado	愴
hbp	愴
hddu	愶
hed	愷
hefl	愷
ldh	愸
hrdj	愺
zesh	愻
zpsh	愻
hfmb	愼
hjb	愼
hjmb	愼
haja	愽
hia	愽
hkl	愾
hkm	愾
hkz	愾
lpdh	愿
yha	愿
hewd	慀
oeqh	慁
wth	慂
wtnh	慂
wtqh	慂
hbue	慃
hct	慄
huac	慅
hubc	慅
heg	慆
feyh	慇
pdnh	慇
pdyh	慇
bav	慈
bewh	慈
bhv	慈
lwlh	慈
rwwh	慈
hlwq	慉
hbef	慊
hqn	慊
dah	態
uha	態
uh	態
uufh	態
hrfs	慌
hs	慌
hdf	慍
hobf	慍
hjb	慎
hjmb	慎
hndl	慏
hrfd	慒
hrod	慒
hcrs	慓
hrdd	慔
rddf	慕
rddh	慕
hoae	慖
hoh	慖
jcsh	慗
vsph	慗
hudm	慘
hum	慘
huum	慘
ckh	慙
hck	慚
hev	慛
vha	慜
vomh	慜
froh	慝
frxh	慝
hldj	慞
hgqd	慟
htd	慟
hhnp	慠
hyfp	慠
hdxx	慡
hjxb	慡
hdfu	慢
hmx	慢
hoa	慣
homb	慣
hoxb	慣
ynrh	慤
hsow	慥
ajwh	慦
nph	慦
ffeh	慧
fh	慧
hdl	慨
hduk	慨
hpdk	慨
hcw	慩
hfoo	慪
bbh	慫
mibh	慫
hrc	慬
zha	慮
zh	慮
zqh	慮
hvdm	慯
hve	慯
cah	慰
cm	慰
crsh	慰
hcua	慱
hjqa	慱
hqa	慱
hxa	慱
hma	慲
hrnb	慲
hruy	慳
heed	慴
hleq	慵
ldn	慶
lyhp	慶
hlew	慷
fnnh	慸
jzh	慹
ybgh	慹
yzh	慹
hmg	慺
hbnm	慻
aqph	慼
haqs	慽
bboh	慾
wih	慾
heem	憀
hem	憀
hpa	憁
hpoh	憁
hak	憂
tdnp	憂
tmnp	憂
yx	憂
fngh	憃
gqdh	憅
hsny	憆
gogh	憇
hzfe	憈
hydm	憉
hyom	憉
pha	憊
pqh	憊
prlh	憊
prph	憊
bha	憋
snsh	憋
anbh	憌
anrh	憌
hgi	憍
hgno	憍
hgo	憍
hpdo	憍
hbo	憎
hbqd	憎
hja	憏
hjrs	憏
hap	憐
hat	憐
hmcs	憐
hmc	憐
bmfh	憑
pkr	憑
hceb	憒
hqa	憒
hch	憓
hcuh	憓
hjqh	憓
hvf	憔
hjd	憕
ladh	憖
lph	憗
hydo	憘
hyoo	憘
ydoh	憙
yobh	憙
yorh	憙
hbqj	憚
hoj	憚
hooj	憚
hcdj	憛
hxj	憛
hbxu	憜
lhzh	憝
lozh	憝
lzph	憝
hlhp	憞
hlop	憞
hlzp	憞
hcm	憟
hzjs	憡
hzj	憡
hyr	憢
hyyr	憢
hmq	憣
hja	憤
hjrb	憤
hffd	憦
hrnd	憦
hlq	憧
irph	憨
trph	憨
gogh	憩
goph	憩
hmu	憪
hmw	憫
hdls	憬
hdbs	憭
hla	憭
hek	憮
hgl	憮
hvff	憮
hkkd	憯
hmno	憰
hgl	憱
hlok	憱
hlsk	憱
nffh	憲
nhfh	憲
nh	憲
nsr	憲
heia	憳
hxl	憴
colh	憵
pha	憵
hldh	憶
hzl	憶
hzz	憶
httz	憷
hae	憸
haob	憸
hoa	憸
hffk	憹
hrok	憹
hnli	憺
hvo	憺
hloe	憻
hlom	憻
nha	憼
rnoh	憼
hrnh	憽
haqh	憾
hkh	憾
hpdp	憿
had	懀
haqd	懀
hfek	懁
hon	懁
hq	懂
hrgq	懂
rcdh	懃
hrcd	懄
hzeq	懅
hzn	懅
hlt	懆
hoot	懆
dkh	懇
eqdh	懇
uqdh	懇
hnds	懈
ia	應
lha	應
lpvh	應
lse	應
hd	懊
hpnd	懊
hpob	懊
tmth	懋
hcn	懌
hfyg	懌
hfy	懌
hloh	懍
hwoo	懎
hvm	懏
hvu	懏
hjfk	懐
hlfk	懐
agoh	懖
wfnh	懘
hea	懙
heih	懚
hte	懛
hyop	懛
hrfc	懜
hfvz	懝
hrnq	懞
aha	懟
fah	懟
febh	懟
uah	懟
hwh	懠
hrf	懢
hrvf	懢
mha	懣
wrnh	懣
hyya	懤
hjnz	懥
hur	懦
hutr	懦
hnht	懧
hnt	懧
hlad	懨
hldd	懨
hyn	懨
hbha	懩
hbhk	懩
hbkx	懩
hdrw	懪
hkkb	懫
hlk	懭
hlrb	懭
htdp	懮
htmp	懮
hyx	懮
hddr	懰
hoar	懰
hrfa	懱
hrfb	懱
hrfe	懱
hrfv	懱
kh	懲
mieh	懲
mikh	懲
hffh	懳
hhhh	懳
hrfm	懵
hbv	懶
hjcb	懶
hvsb	懶
hba	懷
hk	懷
hlfk	懷
mbeh	懸
mbph	懸
mesh	懸
mlsh	懸
msph	懸
muh	懸
hln	懹
hlok	懹
hbbe	懺
hgj	懺
hffb	懻
hmeb	懼
hmmv	懼
qv	懼
hre	懽
hrov	懽
hrrr	懾
hruu	懾
yndh	懿
issh	戀
lfh	戀
sish	戀
rcvh	戁
uvh	戁
hlts	戂
hsnf	戃
hmmu	戄
ldjh	戅
ldjh	戇
aqx	戈
aqi	戉
aqp	戊
aqpe	戌
aqv	戌
aqb	戍
aqpa	戍
aqj	戎
aqx	戎
uaq	戏
aqn	成
aqpy	成
ay	成
ix	我
aqr	戒
aqo	戓
aqaq	戔
kx	戔
gaq	戕
aqoe	或
he	或
zoaq	战
neoq	戙
aqps	戚
as	戚
tmaq	戛
tdnq	戞
tmnq	戞
jaq	戟
jdjq	戟
ldaq	戠
kaq	戡
klbq	戡
klrq	戡
krlq	戡
oraq	戢
jedq	戣
jgnq	戣
kaq	戣
rufq	戤
wpfq	戤
dsaq	戥
adoq	戧
totq	戨
efeq	戩
euuq	戩
odaq	戩
jaqv	截
jvv	截
xaqe	戫
xhe	戫
xuae	戫
xuh	戫
naq	戭
neqq	戭
eebq	戮
emaq	戮
zfeq	戯
bqjq	戰
oaq	戰
ooqq	戰
oq	戰
zoaq	戰
zfeq	戱
uaq	戲
zdaq	戲
zfeq	戲
zq	戲
eevq	戳
jaqb	戴
jb	戴
mmvq	戵
fp	戶
fp	户
fp	戸
fzl	戹
fzz	戹
fol	戺
fdn	戻
oi	戼
rff	戼
yff	戼
yflf	戼
fdj	戽
fad	戾
ffy	房
fki	所
fmj	扁
fzo	扂
fno	扃
fcc	扅
flk	扆
fee	扇
focl	扈
foc	扈
frss	扉
fff	扊
hj	手
up	才
jll	扎
jkl	扏
jkx	扏
jkz	扏
jdx	扐
jdy	扐
jpa	扑
jba	扒
jbn	扒
jti	打
jrp	扔
jye	扗
jgl	托
jqx	扙
jna	扚
jie	扛
juj	扜
jrk	扝
jgj	扞
jzj	扟
jua	扠
jal	扡
jvz	扢
joo	扣
jov	扣
jer	扤
jql	扥
jgj	扦
jka	执
jza	执
jzx	执
jee	扭
jbd	扮
jze	扯
jak	扰
jpu	扱
jrn	扱
jay	扲
jlu	扳
jbr	扴
jbb	扵
jqn	扶
jgn	扷
jpd	扷
jpi	扸
jpy	扸
jbl	批
jxx	扺
jin	扻
jlp	扼
jel	扽
jaq	找
wsbb	承
wsj	承
jju	技
jur	抁
jke	抂
jlp	抃
jsp	抄
jnu	抅
jwx	抆
jdo	抇
jue	抈
jjn	抉
jjv	抉
jcl	把
jha	抋
jkl	抌
jxj	抍
jta	抎
jrr	抏
jfp	抑
jui	抒
jei	抓
jen	抓
jba	抔
jru	投
jdj	抖
jlr	抗
jki	折
jhj	抙
jkd	抛
jxu	抜
jwy	抝
jcn	択
jpu	报
jenb	抦
jen	抦
jtnb	抦
job	抧
jpj	抨
jny	抩
jxn	抪
jpx	披
juo	抬
jnr	抭
jbm	抮
jme	抯
jcn	抰
jnl	抱
jnol	抱
jto	抲
jcf	抳
jsl	抴
jxe	抵
jsn	抶
jbe	抷
jbz	抸
jpaz	抸
jpz	抸
jqb	抹
jys	抹
jqb	抺
jys	抺
jii	抻
jiqi	抻
jqi	押
jiq	抽
jyu	抾
jox	抿
jor	拀
jdo	拁
jvj	拂
jak	拄
jde	担
jka	拆
jom	拇
jzo	拈
jle	拉
jpa	拊
jkd	拋
jbj	拌
jpd	拍
jap	拎
jat	拎
guh	拏
jod	拐
jon	拐
jgo	拑
jff	拒
jlo	拓
jaxu	拔
jaxx	拔
jax	拔
jnf	拕
jva	拖
jwd	拗
jno	拘
jee	拙
jeu	拙
jur	拚
jdo	招
hfj	拜
jfj	拝
jke	拞
jpo	拞
jua	拟
jub	拟
jpr	拠
jlu	拡
jfp	拤
jco	拪
jdk	拫
jgo	括
jaxi	拭
jiv	拭
jyo	拮
jwe	拯
jpk	拰
jrb	拱
rbh	拲
bnh	拳
jbk	拴
jxiz	拵
jsc	拶
jrk	拷
jypk	拷
jcc	拸
jddd	拹
jjns	拺
jjn	拺
jlf	拻
jxf	拻
jbk	拼
jiqx	拽
jix	拽
jqx	拽
jao	拾
aoh	拿
jlk	挀
jya	持
jyy	挂
jpe	挃
jser	挄
jrt	挅
jfd	指
fdh	挈
hdh	挈
jng	按
jre	挋
jpo	挌
jlx	挍
jdrk	挎
jxk	挎
jneo	挏
goh	挐
jra	挑
jrbb	挑
jng	挓
jlk	挔
jrj	挕
jnbz	挖
jnrz	挖
jzv	挖
jen	挗
jjqb	挗
ehj	挙
sebh	挙
lfh	挛
jgn	挟
jse	挡
jso	挡
jan	挨
juvd	挨
jbor	挩
jeb	挪
jbby	挫
jy	挫
jjnz	挬
jtqx	挭
jtx	挭
jbqp	挮
jtp	挮
jfk	振
jok	挰
jws	挱
jws	挲
wsh	挲
jesi	挳
jsi	挳
juy	挳
jvom	挴
jkr	挵
jcyo	挶
jono	挶
jfb	挷
jmr	挸
jocl	挹
joc	挹
jkw	挺
jw	挺
jpzw	挻
jeg	挼
jdcr	挽
jel	挽
jncr	挽
jgn	挾
jgg	挿
jgi	挿
jgqi	挿
jgq	挿
jpf	捀
jso	捁
jwo	捂
jeo	捃
jajw	捄
jna	捄
jtj	捅
jtnq	捅
jot	捆
jyf	捇
jbh	捈
joz	捉
jez	捊
jea	捋
jua	捋
jodr	捌
jonr	捌
jdg	捍
jsu	捎
jdy	捏
jgi	捏
jgy	捏
jou	捐
jdkd	捑
jdvd	捑
jmad	捑
jjcs	捒
jvs	捒
jxb	捓
jyb	捓
jne	捔
jajq	捕
jij	捕
jnrr	捖
jzs	捗
jhx	捘
jubp	捘
jurp	捘
jcj	捙
jqe	捚
jopo	捛
jiqu	捜
jiu	捜
jbor	捝
jncp	捥
jae	捦
jfnq	捧
jbgo	捨
jbo	捨
jbyo	捨
jfad	捩
jxd	捪
jmi	捫
jmy	捫
jlpa	捬
jpg	捭
jpqg	捭
jcjo	据
jpr	捯
jqt	捰
jlyy	捱
jbnl	捲
jbnp	捲
jpl	捲
jkee	捳
jke	捳
jpoe	捳
jbuh	捴
jfb	捵
jrob	捵
jge	捶
jgjy	捶
cz	捷
jjez	捷
jjz	捷
jzez	捷
jew	捸
jdjr	捹
jdrs	捺
jayh	捻
jhg	捼
jjj	捽
jnb	捾
jjeg	捿
jjg	捿
iz	掀
jki	掀
jek	掁
jlzo	掂
jee	掃
jej	掃
jenn	掃
jam	掄
jhu	掅
jnbe	掆
juuu	掇
jenu	授
kg	授
jqj	掉
jzdj	掉
jlo	掊
jlxe	掋
shv	掌
snoh	掌
jdb	掍
jdto	掎
jvo	掎
jni	掏
jnwu	掏
jdg	掐
jgv	掐
jg	掐
jng	掐
jkb	掑
jrss	排
js	排
jfsu	掓
ruh	掔
jlpu	掖
jlx	掖
joe	掗
jcee	掘
jceu	掘
jeev	掙
jee	掙
jne	掙
jpv	掛
jyyp	掛
jyy	掛
jgr	掜
jaqe	掝
jhe	掝
jff	掞
jnez	掟
jnz	掟
jlos	掠
jls	掠
etn	採
jet	採
jmn	採
jnbt	探
jnn	探
jnrt	探
snrh	掣
juu	掤
jlg	接
ji	控
jnbi	控
jnri	控
jve	推
jdil	掩
jdql	掩
jxl	掩
jrd	措
jru	掫
jnm	掬
jgnf	掭
jgnh	掭
jpdf	掭
jpdh	掭
jfu	掮
jzu	掯
hbdh	掰
hhh	掱
jdl	掲
jdnf	掲
judm	掺
jum	掺
juum	掺
jbee	掽
jbe	掽
jbo	掽
jceq	掾
jro	掿
jrxo	掿
jcs	揀
jjqs	揀
js	揀
jzmb	揁
jbe	揂
jber	揃
jbi	揃
jai	揄
jaur	揄
lokh	揅
jjed	揆
jjgn	揆
jkn	揆
jjng	揇
jni	揈
jmt	揉
jeoq	揊
jqk	揋
jqh	揌
jfnd	揍
jfnn	揍
jfn	揍
jnee	揎
jne	揎
jrq	描
jdez	提
jjn	提
jgi	揑
jgy	揑
jgg	插
jfva	揓
jkbl	揕
jklb	揕
jklr	揕
jkl	揕
jkrl	揕
jor	揖
jkm	揗
jxm	揗
jpdk	揘
jfm	揙
jdem	揚
jdvm	揚
jep	揚
jd	換
jnc	換
jnfb	換
jnnd	換
jaor	揜
jpbd	揝
jppd	揝
jld	揞
jfbu	揟
jyzu	揟
jfdg	揠
jcp	握
jnpo	揢
jdi	揣
jer	揣
jetr	揣
jdup	揤
jgi	揤
jlnn	揥
jjcr	揦
jvsr	揦
jcsh	揧
jnsh	揧
jrh	揧
vsrh	揧
jlht	揨
jlnt	揨
jlot	揨
jbpd	揩
jhf	揪
hfh	揫
jdl	揭
jdnl	揭
jnc	揮
jhde	揯
jgq	揰
surh	揱
jst	揲
jfdd	揳
jhdd	揳
jegu	援
jex	援
jew	揵
jrb	揶
jggi	揷
jgg	揷
jtde	揸
jtm	揸
jffu	揹
jdf	揾
jobf	揾
jje	搆
jjny	搆
jayk	搇
jnbo	搈
jnw	搈
jnv	搉
jnee	搊
jlzr	搋
jcrk	搌
jm	損
jomb	損
jzes	搎
jzps	搎
jaja	搏
jav	搏
jia	搏
jlwq	搐
jrr	搑
jgy	搒
jlnf	搒
jbhi	搓
jbki	搓
juac	搔
jubc	搔
juc	搔
jce	搕
jyuf	搕
jewu	搖
juu	搖
juwu	搖
jne	搗
jypd	搘
jfka	搙
jddu	搚
jbef	搛
jqn	搛
jgiu	搜
jgu	搜
jpmd	搝
jlho	搞
jlno	搞
jloo	搞
jqo	搞
jcg	搟
jbeu	搠
juut	搡
jefd	搢
jeud	搢
jaqf	搣
jbef	搤
jye	搤
jpbw	搥
jqbb	搦
jqmm	搦
jfee	搧
jdee	搨
jcst	搩
jct	搩
jleo	搪
zruh	搫
ju	搬
jzru	搬
jzu	搬
jrao	搭
jro	搭
jct	搮
jeg	搯
jqu	搰
jcl	搱
jnbg	搲
jnrg	搲
jnfo	搳
jnho	搳
njbh	搴
njh	搴
jdf	搵
jobf	搵
jado	搶
jbp	搶
jo	搶
jjb	搷
jjmb	搷
jfnh	搸
jeot	搹
jvr	携
aohh	搻
jbnh	搼
jrbt	搽
jnbe	搾
jnbf	搾
jnre	搾
jnrf	搾
haoh	搿
jwf	摀
jodh	摁
jimb	摃
jfu	摆
jfyu	摆
jewu	摇
juu	摇
juwu	摇
jxau	摋
jxtu	摋
jlls	摌
jlps	摌
jwls	摌
jnpd	摍
jeem	摎
jem	摎
jfng	摏
jmiz	摐
joae	摑
joh	摑
joka	摑
jcbk	摒
jpfw	摓
jlbj	摔
jlj	摔
jlwj	摔
jfnn	摕
jja	摖
jjrs	摖
jjci	摗
jvsi	摗
jlno	摘
jxo	摘
jcw	摙
jla	摛
jlxu	摛
jwuu	摛
joa	摜
jomb	摜
joxb	摜
jlb	摝
jqs	摞
jmg	摟
jboh	摠
jpa	摠
jpoh	摠
jdl	摡
jduk	摡
jzh	摢
jdxx	摤
jjxb	摤
jvdm	摥
jve	摥
jdrg	摦
jxg	摦
jev	摧
jcws	摨
lhv	摩
ltth	摩
jgea	摪
jgna	摪
jgua	摪
jqar	摫
jql	摫
jqnr	摫
jldr	摬
jlrf	摭
hnph	摮
yfph	摮
jzh	摯
ybgh	摯
yh	摯
yzh	摯
ybyh	摰
yryh	摰
jdfu	摱
jmx	摱
jck	摲
jfoo	摳
jfx	摳
jurk	摴
jaqs	摵
jcua	摶
jjqa	摶
jqa	摶
jxa	摶
jsqt	摷
jdv	摸
jrdd	摸
rddh	摹
jeed	摺
judm	摻
jum	摻
juum	摻
jruy	摼
jcrs	摽
jqoc	摾
jquc	摾
jbld	摿
ycrh	撀
yhj	撀
jlws	撁
jqpo	撂
cruh	撃
jlbi	撅
bhj	撆
snsh	撆
jbx	撇
jsnp	撇
jffd	撈
jrnd	撈
lhzh	撉
lozh	撉
lzph	撉
jmu	撊
jmk	撋
jceb	撌
jqa	撌
jkkd	撍
jynd	撎
jeia	撏
jsnh	撐
jsnx	撐
jsny	撐
jsnh	撑
jrup	撒
jrx	撒
jqer	撓
jyr	撓
jyyr	撓
jdls	撔
jkbk	撕
jirp	撖
jtrp	撖
jka	撗
jreb	撗
jzao	撘
jbea	撙
jeaf	撚
jjf	撚
jnbf	撚
jnrf	撚
juaf	撚
jmcs	撛
jmc	撛
jjd	撜
jbwf	撝
jewf	撝
jwa	撝
jywf	撝
jlq	撞
jgi	撟
jgno	撟
jgo	撟
jpdo	撟
jjaq	撠
jjdq	撠
juf	撡
juh	撡
juuf	撡
juuh	撡
jcdj	撢
jxj	撢
jbqj	撣
joj	撣
jooj	撣
jp	撤
jtup	撤
jtx	撤
jaxu	撥
jfx	撥
jjk	撥
jjqu	撥
jdh	撦
jdyd	撦
jsdc	撧
jsdl	撧
jsnc	撧
jsnl	撧
jvf	撨
jdbs	撩
jla	撩
juc	撪
judc	撪
jek	撫
jf	撫
jgl	撫
jvff	撫
jmmm	撬
jmq	播
jdeu	撮
jdru	撮
jbhm	撯
jbkm	撯
jflb	撰
jolb	撰
jbxu	撱
jfb	撲
jfed	撲
jpa	撲
jvn	撲
jai	撳
jlhp	撴
jlop	撴
jlzp	撴
jsnr	撹
jdw	撻
jybw	撻
jyw	撻
jaqh	撼
jkh	撼
jpdp	撽
jaw	撾
jqow	撾
jac	撿
jae	撿
jaob	撿
jase	撿
joa	撿
jjbg	擀
jjdg	擀
jlwv	擁
jnq	擁
jv	擁
juq	擂
jffk	擃
jnk	擃
jrok	擃
jzd	擄
jzqd	擄
jloe	擅
jlom	擅
jrh	擆
jryd	擆
jcn	擇
jfyg	擇
jfy	擇
juq	擇
jfel	擈
jfet	擈
jfs	擈
jfnc	擉
ch	擊
cruh	擊
curh	擊
qui	擊
yei	擊
jse	擋
jsnq	擋
jso	擋
jlt	操
joot	操
xt	操
nhj	擎
rnoh	擎
jnx	擏
jrnp	擏
jfek	擐
jon	擐
joar	擑
jorq	擑
jblu	擒
jbl	擒
jbwu	擒
jl	擒
jfwv	擓
jde	擔
jnli	擔
jvo	擔
jvm	擕
jvu	擕
jrdb	擖
jrdl	擖
jrd	擖
jcog	擗
jcol	擗
jpj	擗
colh	擘
phj	擘
jpnd	擙
jpob	擙
jcjo	據
jzeq	據
jzn	據
jrst	擛
jrx	擟
jwh	擠
jwr	擠
jte	擡
jyop	擡
jeev	擢
jfa	擣
jyya	擣
jpmr	擤
rfh	擥
rvah	擥
rveh	擥
jnjs	擦
jnj	擦
ehj	擧
jlzi	擨
jur	擩
jutr	擩
lduh	擪
yhj	擪
jldd	擫
jyn	擫
jfvz	擬
jua	擬
jub	擬
jz	擬
jrvu	擭
jjav	擮
jncb	擯
jnkb	擯
jnpb	擯
jnsb	擯
jnht	擰
jnt	擰
jmpo	擱
jbeb	擲
jbgb	擲
jgb	擲
jzdp	擳
jlk	擴
jlp	擴
jlrb	擴
jlu	擴
jzbr	擶
jzb	擶
jyob	擷
jyot	擷
jsfs	擸
jsl	擸
jsos	擸
jrci	擹
jfuf	擺
jfu	擺
jfyu	擺
jmgp	擻
jufd	擼
jrn	擽
jwpt	擽
jtdp	擾
jtmp	擾
jyx	擾
jlnw	擿
jxw	擿
txxh	攀
jbha	攁
jbhk	攁
jbkx	攁
jrjs	攃
jzqh	攄
jqab	攅
jqnb	攅
jqac	攆
jqnc	攆
jnfh	攇
jnhh	攇
jlbh	攈
juv	攉
jlhz	攊
jjcb	攋
jvsb	攋
jofk	攌
joo	攌
jfua	攍
jfuz	攍
jzqf	攎
jakp	攏
jal	攏
jkap	攏
jlul	攏
jnjk	攐
jeq	攑
jnjz	攓
jbs	攔
jmcs	攔
jmjs	攔
jmn	攔
jbbe	攕
jmbg	攖
jsg	攖
jlbm	攗
jln	攘
jlok	攘
jeb	攙
jncb	攙
jnoa	攙
jnoe	攙
jnbc	攛
jnbs	攛
jnrc	攛
jnrs	攛
jevm	攜
jevo	攜
jevr	攜
jevt	攜
jevu	攜
jvm	攜
jvr	攜
jvu	攜
jrrr	攝
jruu	攝
jrv	攝
jfc	攞
jfsv	攞
jlbh	攟
jlbo	攟
jlts	攠
jlv	攡
jwuv	攡
jwxv	攡
jsrb	攢
issh	攣
lfh	攣
sish	攣
jrcv	攤
juv	攤
jzms	攥
jllb	攦
jnbg	攨
jnrg	攨
jsnf	攩
jsnr	攪
jmmu	攫
jrfr	攬
jrvr	攬
jvl	攬
jcec	攭
jjck	攮
jvnk	攮
jux	支
lju	攱
dtou	攲
vju	攲
juea	攳
zux	攴
px	攵
gpx	收
kpx	攷
pip	攸
flp	改
ipx	攻
bdp	攽
fpx	放
ezp	政
pdp	敀
zop	敁
zozu	敁
nop	敂
oxp	敃
mpx	敄
jop	故
jx	故
aozu	敆
lxd	效
lxp	效
mpx	敉
fszu	敊
pop	敋
atzu	敍
bhzu	敍
gp	敎
xxzp	敎
vomp	敏
vx	敏
ajwp	救
ap	救
npx	救
borp	敓
boru	敓
wop	敔
jcsd	敕
jcsp	敕
vsd	敕
vsp	敕
hnp	敖
yfp	敖
mbp	敗
atp	敘
atu	敘
atzu	敘
bhp	敘
bhu	敘
bhzu	敘
gp	教
xxzp	教
ypzp	教
borp	敚
ayhp	敜
bxv	敝
bx	敝
snsp	敝
snop	敞
sx	敞
fbp	敟
rorp	敟
uuuu	敠
dnmu	敡
ezu	敡
irp	敢
trp	敢
rup	散
rxv	散
rx	散
qtju	敤
qtzu	敤
ffju	敥
ffzu	敥
lhzp	敦
lozp	敦
lzp	敦
dtou	敧
vzu	敧
lop	敨
uuup	敪
pdfp	敫
nx	敬
rnop	敬
denp	敭
dvmp	敭
epx	敭
oxdu	敯
mgp	数
edzu	敱
lhnu	敲
lnou	敲
lonu	敲
qju	敲
qzu	敲
edp	敳
jcsz	整
vspz	整
z	整
gop	敵
lnjp	敵
xpx	敵
bcsp	敶
bjqp	敶
ajnp	敷
ifp	敷
mgp	數
znep	敹
znmp	敹
foou	敺
fxzu	敺
nfmp	敻
nnbp	敻
nobp	敻
ydou	敼
yobu	敼
yoru	敼
edop	敿
gnop	敿
gpx	敿
pdop	敿
fncu	斀
fybp	斁
fyp	斁
adep	斂
aobp	斂
aoop	斂
apx	斂
asep	斂
opx	斂
bdf	斃
bfv	斃
snsf	斃
qbpl	斄
yspl	斄
snzu	斅
wx	文
wzj	斈
whe	斉
wri	斋
wtnr	斋
weaz	斌
wwe	斌
ww	斌
wmr	斍
whs	斎
wrrs	斎
wrsr	斎
rssw	斐
kwk	斑
wfm	斒
wcgb	斔
wbs	斕
wmcs	斕
wmjs	斕
wmn	斕
wsnm	斖
dj	斗
mdj	料
uund	斚
ndj	斛
atd	斜
bhd	斜
oond	斝
gbd	斞
kdj	斟
klbd	斟
klrd	斟
krld	斟
jdj	斠
jnyd	斠
jbd	斡
jdjd	斡
kdj	斢
reqd	斢
ki	斤
kaa	斥
kav	斥
kax	斥
kki	斦
bxk	斧
gki	斨
nok	斪
lok	斫
cki	斬
lmk	断
mlk	断
rdk	斮
kbk	斯
li	新
ltk	新
oki	斲
ook	斲
oook	斲
xki	斲
rck	斳
ddok	斵
ook	斵
kfnc	斶
fk	斷
fwwk	斷
lmk	斷
lwwk	斷
mlk	斷
wwek	斷
wwfk	斷
cwfk	斸
fy	方
fbr	斺
fvr	斻
fbb	於
ubb	於
uj	於
fva	施
fvn	斾
fj	斿
fvz	斿
gy	旁
lnf	旁
fvk	旂
fvne	旃
fvnl	旃
fvm	旄
fvk	旅
fvjn	旆
fvln	旆
fvp	旇
ajnf	旉
ajnn	旉
ajnv	旉
ien	旉
ify	旉
ivy	旉
fvw	旊
fvfb	旋
fvyz	旋
fzv	旋
fvs	旌
fvap	旍
fvat	旍
fvcf	旎
av	族
fvvd	族
fvrb	旐
fvr	旐
fdto	旑
fvo	旑
fvts	旒
fvsu	旓
fvdo	旖
fvv	旖
fbv	旗
fg	旗
fvkb	旗
fvcs	旚
fvmq	旛
fpie	旜
fpim	旜
fvle	旜
fvlm	旜
fvad	旝
fvbw	旞
fve	旟
ekl	无
gll	无
kl	旡
dl	既
duk	既
pdfk	既
adfk	旣
dl	旣
duk	旣
pdfk	旣
onbk	旤
qok	旤
do	日
deev	旦
dee	旦
dev	旦
de	旦
ido	旧
fdo	旨
djj	早
djj	旪
ddp	旫
ndo	旬
kdo	旭
kdo	旮
dkl	旯
dkx	旯
dkz	旯
dgj	旰
dgj	旱
ddn	旲
dna	旳
duj	旴
dei	旵
daa	时
h	时
dke	旺
dwx	旻
dwx	旼
del	旽
edo	旾
dwj	旿
dnb	昀
dnr	昀
djn	昁
dln	昁
dfp	昂
dip	昂
dlb	昃
dlu	昄
dpu	昅
drn	昅
dbl	昆
dxj	昇
dfp	昈
dfy	昉
ded	昊
dgn	昊
edd	昋
gnd	昋
pdd	昋
ddo	昌
ddo	昍
due	明
xdo	昏
dbd	昐
day	昑
dnm	昒
dnm	易
ep	易
rdo	昔
dki	昕
dla	昗
dfy	昘
dbd	昚
dff	昛
denm	昜
dvm	昜
ep	昜
pbd	昝
ppd	昝
denb	昞
den	昞
dtnb	昞
dse	星
dcn	映
dlw	昡
dee	昢
deu	昢
dbm	昣
dap	昤
dat	昤
fnd	春
ddr	昦
dqb	昧
dys	昧
dvf	昨
dqb	昩
dys	昩
dno	昫
oxd	昬
ddo	昭
did	昮
dez	是
jn	是
dez	昰
dle	昱
dvj	昲
dsn	昳
ddp	昴
dcf	昵
dfro	昵
udo	昶
dfe	昷
obf	昷
dpb	昸
dun	昹
denb	昺
den	昺
dfp	昻
dip	昻
cnde	昼
dra	晀
drbb	晀
dra	晁
drbb	晁
daa	時
dya	時
h	時
dser	晃
dser	晄
dede	晅
dyy	晆
ddrk	晇
dxk	晇
dlx	晈
efed	晉
euud	晉
odo	晉
dpe	晊
efed	晋
euud	晋
odo	晋
dpno	晌
dneo	晍
drb	晎
dng	晏
dlh	晐
dpno	晑
dco	晒
dayo	晗
dhx	晙
dubp	晙
durp	晙
ddcr	晚
del	晚
dncr	晚
dr	晚
dmr	晛
dbqp	晜
dtp	晜
cnde	晝
ede	晝
dxxn	晞
daqn	晟
daqy	晟
day	晟
daqn	晠
daqy	晠
day	晠
dajq	晡
dij	晡
jkd	晢
djk	晣
dwo	晤
dnrr	晥
dvom	晦
dso	晧
dfk	晨
del	晩
dncr	晩
dr	晩
dfb	晪
drob	晪
dqj	晫
dzdj	晫
djj	晬
dno	晭
dnyo	晭
bdo	普
befd	普
bod	普
dlos	景
dls	景
ds	景
dtk	晰
dff	晱
dgr	晲
tkd	晳
dhu	晴
ddd	晶
dpbo	晷
dppo	晷
dezp	晸
ddnm	晹
dep	晹
vdod	智
vd	智
ddil	晻
ddql	晻
dxl	晻
dncp	晼
dtt	晽
dlos	晾
dls	晾
ddd	晿
dmik	暀
djrr	暁
dqer	暁
dyr	暁
dyyr	暁
dnee	暄
dne	暄
dfva	暆
dofu	暇
dox	暇
dnc	暈
dnc	暉
dta	暊
dtmb	暊
oxpd	暋
djed	暌
djgn	暌
dkn	暌
ddl	暍
ddnl	暍
drc	暎
dho	暏
dyd	暏
dypd	暏
dwj	暐
dwos	暐
dho	暑
dypd	暑
dds	暒
mpd	暓
djng	暔
dcs	暕
djqs	暕
degu	暖
dex	暖
dld	暗
ddem	暘
ddvm	暘
dep	暘
dfnd	暙
dewu	暚
duu	暚
duwu	暚
lld	暜
dndl	暝
ded	暟
dlho	暠
dlno	暠
dloo	暠
dqo	暠
dbue	暡
idem	暢
idvm	暢
iep	暢
iqie	暢
iqim	暢
dpdj	暤
ddng	暥
lttd	暦
dde	暨
duke	暨
pdfe	暨
dja	暩
djrs	暩
dma	暪
drnb	暪
ckd	暫
ybyd	暬
yryd	暬
yzd	暬
dpdj	暭
rddd	暮
rdv	暮
drdd	暯
dmiz	暰
dcf	暱
dfro	暱
dldj	暲
dffe	暳
dhhe	暳
drbw	暴
dw	暴
drc	暵
dfvz	暶
dcua	暷
djqa	暷
dqa	暷
dxa	暷
ddbs	暸
dla	暸
dvw	暹
doj	暺
dooj	暺
ddls	暻
bdo	暼
snsd	暼
dmcs	暽
dmc	暽
dlhp	暾
dlop	暾
dlzp	暾
dydo	暿
dyoo	暿
dynd	曀
adfe	曁
dde	曁
duke	曁
pdfe	曁
deww	曃
daj	曄
dpfj	曄
drjq	曄
drrj	曄
drrq	曄
daj	曅
drjq	曅
drrj	曅
lhhd	曆
dru	曇
dta	曇
dut	曇
dlq	曈
dqer	曉
dyr	曉
dyyr	曉
dvmb	曊
dcdj	曋
dxj	曋
duni	曌
dfyg	曎
dfy	曎
dwab	曏
dxi	曏
ddds	曐
dddm	曑
dpdp	曒
dnx	曔
drnp	曔
dnli	曕
dvo	曕
denp	曖
dhx	曖
dfel	曗
dfet	曗
dfs	曗
dur	曘
dutr	曘
dfh	曙
dfyd	曙
drnq	曚
dgqf	曛
deev	曜
dvv	曜
ddrw	曝
dlru	曞
dddk	曟
dlk	曠
dlp	曠
dlrb	曠
dddm	曡
drff	曣
drof	曣
duv	曤
dzqf	曥
dbkk	曦
dbkr	曦
deoc	曧
dal	曨
dlul	曨
dln	曩
dlok	曩
issd	曫
lfd	曫
sisd	曫
dla	曬
dllb	曬
dsnf	曭
doop	曮
dox	曮
dcwc	曯
do	曰
fo	曲
ror	曲
iqx	曳
ix	曳
qxx	曳
tqx	更
tx	更
aiqx	曵
aix	曵
nmd	曶
dl	曷
dnbl	曷
dnlb	曷
asj	書
edo	書
rfd	曹
rord	曹
dfu	曼
mx	曼
bo	曾
bqd	曾
qaqd	替
qnqd	替
td	替
deru	最
dru	最
kkd	朁
ada	會
ad	會
aqd	會
bta	會
ics	朄
ijqs	朄
iqis	朄
yudb	朅
yudl	朅
yud	朅
bnm	朆
bqdm	朆
ue	月
xue	有
x	有
urr	朊
uue	朋
ubd	朌
upu	服
uu	服
uap	朎
uat	朎
uee	朏
ueu	朏
uno	朐
unbb	朒
ura	朓
urbb	朓
beu	朔
ubed	朕
ubgn	朕
ugn	朕
uadk	朖
uan	朖
adku	朗
aduu	朗
aue	朗
uhx	朘
uubp	朘
uurp	朘
ornu	朙
fdu	朚
fek	望
fuk	望
jdju	朝
jue	朝
kbu	朞
kbu	期
urc	朠
uxup	朡
ruk	朢
ulq	朣
uuuu	朤
urnq	朦
uakp	朧
ual	朧
ulul	朧
tn	木
qbn	未
ysn	未
qbn	末
ysn	末
ys	末
tej	本
tll	札
atl	朮
atn	术
at	术
sbn	朱
ssn	朱
tbn	朲
tbn	朳
tpa	朴
rtn	朵
rtn	朶
tdp	朷
tdx	朸
tdy	朸
tkl	朹
tkx	朹
tkz	朹
trl	机
trz	机
tgi	朻
tfl	朼
tkk	朽
tti	朾
jns	朿
jn	朿
tgj	杄
tuj	杅
tgj	杆
trk	杇
tua	杈
tmp	杉
tsi	杊
tra	杋
ter	杌
tzj	杍
tzj	李
too	杏
tup	材
ebi	村
taa	村
tda	杒
tna	杓
tgl	杔
tdn	杕
tqv	杖
tqx	杖
ftn	杗
ctn	杘
tax	杙
tvz	杚
tqk	杛
tqy	杛
tye	杜
tal	杝
tfl	杞
jcs	束
vsn	束
tie	杠
ptn	条
tsp	杪
tze	杫
trr	杬
tlr	杭
tba	杯
tfa	杰
csa	東
csn	東
jqs	東
dtn	杲
tdo	杳
tin	杴
twj	杵
tel	杶
tcl	杷
tru	杸
tpf	杹
tha	杺
tee	杻
tui	杼
thj	杽
tbu	松
tlu	板
but	枀
tpu	极
trn	极
tue	枂
tnb	枃
tnr	枃
tnu	构
tkj	枅
tml	枆
tbl	枇
tke	枉
tfp	枊
tfy	枋
tbd	枌
tak	枍
tbk	枍
tqn	枎
tnr	枏
tue	枏
tki	析
tde	枑
txp	枒
typ	枒
tdj	枓
tay	枔
tkl	枕
tnrr	枕
tnr	枕
tgn	枖
tpd	枖
ttn	林
tnb	枘
tlp	枙
tpx	枚
qtn	果
rqt	果
tju	枝
tta	枟
tfx	枢
jba	枣
jnsb	枣
tzo	枮
tjo	枯
tpj	枰
tuo	枱
uot	枲
tob	枳
tod	枴
tok	枵
dot	架
tdo	枷
tno	枸
tnl	枹
tnol	枹
tqb	枺
tys	枺
tsl	枻
stn	枼
tjr	枿
tpx	柀
tnf	柁
tva	柂
tap	柃
tat	柃
tenb	柄
ten	柄
ttnb	柄
tcf	柅
tle	柆
thn	柇
tbj	柈
tbz	柉
tpaz	柉
tpz	柉
tpb	柊
paxt	柋
teo	柌
tyeo	柌
tcn	柍
tpa	柎
tpd	柏
gtn	某
tgo	柑
tgv	柑
bct	柒
bft	柒
wct	柒
wft	柒
wkt	染
mtn	柔
tmp	柕
tdo	柖
tbo	柗
tro	柗
tlo	柘
tqi	柙
tiq	柚
tii	柛
tiqi	柛
tff	柜
tka	柝
tvf	柞
tny	柟
txe	柢
tsn	柣
tme	柤
tde	查
tme	查
tde	柦
tga	柧
txn	柨
tfnn	柩
twd	柪
tvj	柫
csn	柬
jqs	柬
taxx	柭
tax	柭
tee	柮
teu	柮
tto	柯
trs	柰
tak	柱
thp	柲
tdp	柳
zft	柴
tmj	柵
tnne	柵
tnr	柵
tfo	柶
tor	柷
tbe	柸
tjp	柹
ton	柺
tde	査
tme	査
tnb	柼
tez	柾
tln	柿
tfp	栀
tcp	栁
tmj	栅
tnne	栅
tnd	栒
tbk	栓
fdt	栔
hdt	栔
tre	栕
tco	栖
ctn	栗
tcc	栘
tps	栙
tbed	栚
tbgn	栚
tgn	栚
tddd	栛
tjns	栜
tjn	栜
tgo	栝
ggt	栞
ktn	栞
tbk	栟
pkt	栠
tlx	校
ttd	栢
tpk	栣
tbw	栤
bit	栥
rit	栥
tyyy	栦
tiqx	栧
tix	栧
tbi	栨
tri	栨
tee	栩
tsb	株
tss	株
txiz	栫
tdcl	栬
tdc	栬
tncl	栬
tnc	栬
tri	栭
ttnr	栭
trj	栮
txe	栯
txu	栯
tpaq	栰
trb	栱
trk	栲
typk	栲
typf	栳
tvne	栴
tvnl	栴
tdr	栵
tod	栶
tbh	样
tlh	核
tdk	根
tfd	栺
taxi	栻
tpo	格
jaqt	栽
jt	栽
lft	栾
cst	桀
ctn	桀
tmii	桁
tmit	桁
tyy	桂
tra	桃
trbb	桃
tser	桄
tnlp	桅
tnp	桅
tfk	框
got	桇
ngt	案
tng	桉
ten	桋
tjqb	桋
zdt	桌
tdrk	桍
txk	桍
tpe	桎
tib	桏
tneo	桐
uuut	桑
jrs	桒
jrt	桒
tede	桓
tyo	桔
tge	桕
tpf	桖
tpb	桘
tus	桙
tws	桫
wst	桬
tfk	桭
tbo	桮
tok	桯
txo	桰
tesi	桱
tsi	桱
tuy	桱
tjnz	桲
tudj	桳
tuj	桳
tute	桳
tez	桴
teg	桵
ttj	桶
ttnq	桶
tne	桷
txxn	桸
tadk	桹
tan	桹
terf	桺
toi	桺
txi	桺
tyff	桺
tpf	桻
gnw	桼
tbw	桼
twa	桼
tbby	桽
teo	桾
tdg	桿
tgj	桿
tjcs	梀
tvs	梀
wdat	梁
wdbt	梁
wt	梁
tajw	梂
tna	梂
tkw	梃
teo	梄
tmv	梅
tvom	梅
tfb	梆
tkr	梇
tgy	梉
jkt	梊
tou	梋
tat	梌
tbh	梌
tpdc	梎
tpdf	梎
tso	梏
tby	梐
tqf	梑
tayo	梒
tlj	梓
tfcl	梔
tfc	梔
tdah	梕
tmb	梖
ttqx	梗
ttx	梗
tmr	梘
tcc	梙
tel	梚
tncr	梚
teb	梛
tgn	梜
pipt	條
pn	條
ptn	條
tflh	梞
ntn	梟
topo	梠
tnrr	梡
tsu	梢
teay	梣
tebd	梤
nbut	梥
nrut	梥
tc	梦
ttc	梦
two	梧
hdt	梨
hrt	梨
tqe	梩
tde	梪
tenu	梫
trx	梫
tiqk	梬
thx	梭
tubp	梭
turp	梭
tcyo	梮
tono	梮
tbqp	梯
ttp	梯
taqr	械
tr	械
tot	梱
tbor	梲
tts	梳
tpzw	梴
ttra	梵
ttz	梵
tcm	梶
zout	梷
thr	梸
tkeb	梹
tpob	梹
tbor	棁
hdt	棃
trj	棄
trt	棄
tst	棄
tges	棅
tam	棆
tbuh	棇
thu	棈
tpdn	棉
tpj	棉
kbt	棊
tkb	棋
tet	棌
tmn	棌
tdb	棍
tnbt	棎
tnn	棎
tnrt	棎
tda	棏
tdua	棏
rsst	棐
trss	棑
tfnq	棒
tq	棒
tlo	棓
txd	棔
tnrs	棕
tns	棕
tek	棖
jjn	棗
jnss	棗
jjn	棘
jnss	棘
tuu	棚
ttu	棛
tfbb	棜
tojo	棝
toh	棞
tcs	棟
tjqs	棟
snot	棠
tnbe	棡
tnbf	棢
tew	棣
trd	棤
txxt	棥
tee	棦
tne	棦
taf	棧
taqq	棧
tkx	棧
fpt	棨
thi	棩
thp	棩
tff	棪
taqe	棫
the	棫
tbnl	棬
tbnp	棬
tpl	棬
tlpu	棭
tlx	棭
ttt	森
tayh	棯
tge	棰
tgjy	棰
tybp	棱
tyrp	棱
tyx	棱
tjeg	棲
tjg	棲
tuuu	棳
tupu	棴
tqt	棵
tln	棶
tru	棷
rut	棸
tqj	棹
tzdj	棹
tnb	棺
rbdt	棻
ttbd	棼
ttay	棽
ttnr	棾
tgr	棿
tncp	椀
tlhz	椁
tloz	椁
tlz	椁
tcew	椂
tew	椂
tzr	椃
tlg	椄
tdto	椅
tvo	椅
tno	椆
tnyo	椆
tmeb	椇
tnm	椈
lcst	椉
lct	椉
tjj	椊
tlos	椋
tls	椋
tnbi	椌
tnri	椌
tje	植
tjl	植
tjme	植
tjml	植
tve	椎
tefe	椏
toe	椏
tcjo	椐
tpg	椑
tpqg	椑
tfsu	椒
teqa	椓
teq	椓
tsq	椔
tbdt	椕
tnez	椗
tnz	椗
ttaz	椘
tacb	検
tac	検
tkt	椞
tvdo	椥
tbee	椪
tbe	椪
tbo	椪
tdi	椯
ter	椯
tetr	椯
trb	椰
tvdp	椱
tvx	椱
twj	椲
twos	椲
tqk	椳
teru	椴
tofu	椵
tox	椵
txup	椶
taqo	椷
tko	椷
tfva	椸
tkbl	椹
tklb	椹
tklr	椹
tkl	椹
tkrl	椹
tfdg	椻
tmii	椼
tmit	椼
tceq	椽
tber	椾
tbi	椾
tfnd	椿
tpcu	楀
tnpo	楁
ttde	楂
ttm	楂
tcp	楃
tfm	楄
teoq	楅
tcg	楆
tvx	楆
tonb	楇
tqo	楇
tfbu	楈
tyzu	楈
tro	楉
trxo	楉
tdem	楊
tdvm	楊
tep	楊
tjcr	楋
tvsr	楋
tlpm	楌
twlm	楌
tooo	楍
tnc	楎
tdyy	楏
tqbr	楐
tjed	楑
tjgn	楑
tkn	楑
tqh	楒
trc	楓
trx	楓
tfdd	楔
thdd	楔
txiu	楕
tdup	楖
tgi	楖
tew	楗
mpt	楘
tmt	楙
ttfb	楚
ttyz	楚
tz	楚
trjo	楛
tfu	楜
tjou	楜
tcs	楝
tjqs	楝
tff	楞
tlht	楟
tlnt	楟
tlot	楟
tjng	楠
tnj	楠
tai	楡
taur	楡
tbe	楢
tcm	楣
tnqh	楤
tegu	楥
tex	楥
tnee	楦
tne	楦
trc	楧
tzmb	楨
tptx	楩
tpt	楩
tst	楪
tor	楫
tdl	楬
tdnl	楬
febl	業
febt	業
fee	業
ferl	業
fert	業
fr	業
fsn	業
tho	楮
typd	楮
tkm	楯
txm	楯
tgb	楰
tfnd	楱
tfn	楱
tgt	楳
tlnn	楴
tkoe	極
tk	極
tpu	極
trn	極
twoe	極
biot	楶
riot	楶
tbpd	楷
thf	楸
truf	楹
twpf	楹
tmt	楺
tpdk	楻
tmg	楼
bpdt	楽
pdbt	楽
rn	楽
tdl	概
tduk	概
tpdk	概
ttq	榃
tdf	榅
tobf	榅
tai	榆
taur	榆
tcsu	榍
ttmp	榎
tbef	榏
tye	榏
tcrk	榐
taja	榑
tia	榑
tqbb	榒
tqmm	榒
thpf	榓
tab	榔
tadb	榔
tnbo	榕
tnw	榕
yneu	榖
ynhu	榖
yntu	榖
tefd	榗
teud	榗
tod	榗
vdft	榘
trao	榙
tro	榙
tbkf	榚
tfnh	榛
tgy	榜
tlnf	榜
txau	榝
txtu	榝
tlps	榞
tya	榞
tnl	榟
tndl	榠
ths	榡
tneq	榢
tewu	榣
tuu	榣
tuwu	榣
tcst	榤
tct	榤
tdsr	榥
jbt	榦
jdjt	榦
tfrs	榧
tnbe	榨
tnbf	榨
tnre	榨
tnrf	榨
tzw	榩
tmf	榪
tvj	榫
tyok	榬
tsa	榭
ffnt	榮
ft	榮
rnt	榮
snt	榮
tdya	榯
typd	榰
tldk	榱
tdf	榲
tobf	榲
tlkw	榳
tddq	榴
toq	榴
trr	榵
tleo	榶
tnv	榷
tlzr	榹
tdee	榻
tce	榼
tyuf	榼
tewd	榽
tqu	榾
ted	榿
lhnt	槀
lnot	槀
lont	槀
qtn	槀
tlno	槁
tloo	槁
tqo	槁
tzes	槂
tzps	槂
zrut	槃
teg	槄
teot	槅
trnd	槆
tfka	槈
tlbd	槉
beut	槊
tje	構
tjny	構
tnu	構
ty	構
tpbw	槌
tado	槍
tbp	槍
tbhi	槎
tbki	槎
tbef	槏
tqn	槏
tpqu	槐
tpru	槐
tva	槐
oott	槑
otot	槑
tlwq	槒
tie	槓
timb	槓
tpdj	槔
tpdt	槔
tzdt	槕
ynlt	槖
tbku	様
tbkw	様
tjb	槙
tjmb	槙
teed	槢
tndo	槣
tnv	槣
tcw	槤
tffe	槥
tleq	槦
ckt	槧
tlhb	槨
tlob	槨
tlzb	槨
adft	槩
dtn	槩
dukt	槩
pdft	槩
tadk	槪
tdl	槪
tduk	槪
tpdk	槪
tcua	槫
tjqa	槫
tqa	槫
txa	槫
tdrg	槬
txg	槬
taqs	槭
tudm	槮
tum	槮
tuum	槮
tev	槯
tpfw	槰
tef	槱
tnd	槲
gct	槳
geat	槳
guat	槳
tfoc	槴
tfol	槴
toae	槶
toh	槶
jzt	槷
ybyt	槷
yryt	槷
yzt	槷
tyba	槸
tybz	槸
tyra	槸
tyrz	槸
tyz	槸
tadj	槹
tpdj	槹
tlew	槺
tqar	槻
tql	槻
tqnr	槻
qamt	槼
qnmt	槼
qtn	槼
trfd	槽
trod	槽
tdfu	槾
tmx	槾
trc	槿
tlno	樀
txo	樀
tfng	樁
fsa	樂
pdwt	樂
rn	樂
wpdt	樂
tbcs	樄
tbjs	樄
tmiz	樅
tla	樆
tlxu	樆
twuu	樆
tpiu	樇
tldr	樈
tdxx	樉
tjxb	樉
txxd	樊
ttnw	樋
ttn	樋
ttw	樋
toa	樌
tomb	樌
toxb	樌
thmb	樍
tnpd	樎
tqs	樏
tzof	樐
tzox	樐
ttv	樑
twdt	樑
tnhe	樒
tg	樓
tmg	樓
tsqt	樔
tjci	樕
tvsi	樕
aoto	樖
turk	樗
tsny	樘
tcrs	標
trs	標
ts	標
tlb	樚
teem	樛
tem	樛
tlrf	樜
tzm	樝
tfoo	樞
tfx	樞
tldj	樟
tma	樠
trnb	樠
tdv	模
trdd	模
tv	模
tnf	樢
tbh	樣
tbku	樣
tbkw	樣
tu	樣
tpip	樤
tpit	樤
tpn	樤
trpf	樥
tzak	樦
txau	樧
txtu	樧
tcws	樨
tve	権
twv	権
tka	横
trqb	横
tpa	樬
tpoh	樬
taxb	樲
taxr	樲
tea	樳
teia	樳
tlad	樴
tvf	樵
tdeu	樶
tdru	樶
tteu	樷
ttru	樷
tfb	樸
tfed	樸
tvn	樸
tua	樹
tyda	樹
tyoa	樹
taj	樺
tpfj	樺
trjq	樺
trrq	樺
tceb	樻
tqa	樻
tczz	樼
tbea	樽
tyzi	樾
toj	樿
tooj	樿
ttsf	橀
tznd	橁
tbed	橂
tfx	橃
tjqu	橃
tirp	橄
ttrp	橄
tvff	橅
vftt	橆
tmmm	橇
tqer	橈
tyr	橈
tyyr	橈
tmcs	橉
tmc	橉
tefq	橊
terq	橊
toq	橊
txq	橊
tyfq	橊
tedo	橋
tgi	橋
tgno	橋
tgnr	橋
tgo	橋
tpdo	橋
tmu	橌
tmk	橍
tmq	橎
tbho	橏
tbko	橏
jcnt	橐
vnlt	橐
tdbs	橑
tla	橑
tut	橒
tcns	橓
tenc	橓
tlhp	橔
tlop	橔
tlzp	橔
tsnx	橕
tsny	橕
tsnt	橖
trdu	橗
tmno	橘
tjd	橙
teh	橚
tlbi	橛
lbet	橜
tcdj	橝
txj	橝
tch	橞
tcuh	橞
tjqh	橞
g	機
trl	機
twb	機
twwb	機
tlck	橠
tncq	橡
tnn	橡
tbxu	橢
tnhq	橣
tnhy	橣
hhht	橤
tlq	橦
tbo	橧
tbqd	橧
tja	橨
tjrb	橨
tffr	橩
teaf	橪
tjf	橪
tnbf	橪
tnrf	橪
tuaf	橪
tka	橫
treb	橫
tkkd	橬
tjog	橭
tjol	橭
tddb	橮
tomb	橮
tffd	橯
tamj	橰
tpmj	橰
tlda	橱
tjaq	橶
tjdq	橶
tybw	橽
tyw	橽
tlt	橾
toot	橾
teqe	橿
tloe	檀
tlom	檀
tloh	檁
tffk	檂
trok	檂
beit	檃
tpdp	檄
tzas	檅
tffo	檆
tvm	檇
tvu	檇
tfek	檈
ton	檈
trok	檉
tjbg	檊
tjdg	檊
tfrs	檌
tldh	檍
tblu	檎
tbl	檎
tbwu	檎
tfel	檏
tfet	檏
tfs	檏
tnli	檐
tvo	檐
tuq	檑
ttrc	檒
tgyu	檓
tse	檔
tsnq	檔
tso	檔
curt	檕
tbew	檖
colt	檗
ptn	檗
tcol	檘
tpj	檘
tmd	檙
tttz	檚
tqow	檛
tad	檜
taqd	檜
tbt	檜
toar	檝
torq	檝
tnds	檞
tcmb	檟
ntn	檠
rnot	檠
tcn	檡
tfyg	檡
tfy	檡
tac	檢
tae	檢
taob	檢
tase	檢
tb	檢
toa	檢
twoo	檣
tbtw	檤
thw	檤
tbki	檥
tbx	檥
tcrr	檦
trnh	檧
tbki	檨
tnjs	檫
tnj	檫
trnq	檬
tadk	檭
tfa	檮
tyya	檮
tte	檯
tuo	檯
tyop	檯
tspn	檰
tsp	檰
tzkb	檱
toca	檲
toja	檲
tox	檲
tbv	檳
tncb	檳
tnkb	檳
tnpb	檳
tnsb	檳
trvu	檴
tfww	檵
tlww	檵
tdfo	檶
trx	檷
tnht	檸
tnt	檸
tfvo	檹
tfvv	檹
tlhq	檺
tlnq	檺
tloq	檺
trf	檻
trvf	檻
teih	檼
tur	檽
tutr	檽
ffnt	檾
rntt	檾
ldut	檿
ytn	檿
tkbs	櫀
tnhc	櫁
teev	櫂
tfcb	櫃
tff	櫃
tfq	櫃
tgqf	櫄
twh	櫅
tpqd	櫆
tvd	櫆
tptb	櫇
tpt	櫇
tjdr	櫈
tpmf	櫋
ttdp	櫌
ttmp	櫌
tyx	櫌
tkkb	櫍
tlk	櫎
tlrb	櫎
tcdw	櫏
qqqt	櫐
tqqq	櫑
trjs	櫒
trj	櫒
tufd	櫓
tlru	櫔
tqab	櫕
tqnb	櫕
trfa	櫗
trfb	櫗
trfv	櫗
tffh	櫘
thhh	櫘
trfo	櫙
tmoo	櫚
trp	櫛
tzap	櫛
tzdp	櫛
tzg	櫛
tzp	櫛
jcnt	櫜
vnpt	櫜
tjm	櫝
txbd	櫝
tyfb	櫝
tym	櫝
tscq	櫞
tpdt	櫟
trn	櫟
twpt	櫟
tlf	櫠
tlju	櫠
tzh	櫡
tzyd	櫡
tmgp	櫢
trcw	櫣
tlda	櫥
tlya	櫥
tih	櫧
tiyd	櫧
tzqf	櫨
tmng	櫩
tld	櫪
tlhz	櫪
eqht	櫫
eqyt	櫫
tll	櫬
tltr	櫬
tdde	櫭
tdue	櫭
tkoo	櫮
ttoe	櫮
ttol	櫮
tufh	櫯
tlfk	櫰
eblt	櫱
epbt	櫱
tal	櫳
tlul	櫳
tjcb	櫴
tvsb	櫴
teh	櫸
teq	櫸
treh	櫹
tuoo	櫺
tmbg	櫻
tsg	櫻
tbbe	櫼
beit	櫽
tews	櫾
tuus	櫾
tuws	櫾
tffo	櫿
trno	櫿
tln	欀
tlok	欀
tfft	欁
trot	欁
trwa	欂
tnoa	欃
tbs	欄
tmcs	欄
tmjs	欄
tmn	欄
tvvu	欆
trrr	欇
tevo	欈
tfeu	欉
tfru	欉
tre	權
trov	權
tux	權
tve	權
tmmv	欋
tfc	欏
tfsv	欏
tvc	欏
tllb	欐
tsrb	欑
isst	欒
lft	欒
sist	欒
tsnf	欓
tmmu	欔
trfr	欖
trvr	欖
tvl	欖
trms	欗
trm	欗
tcwc	欘
tqqs	欙
tcec	欚
turu	欛
tjck	欜
tvnk	欜
txxa	欝
tuow	欞
in	欠
bin	次
rin	次
uin	欢
kin	欣
din	欥
ayi	欦
fooi	欧
fxi	欧
noi	欨
eei	欪
eui	欪
wzi	欫
lhi	欬
odi	欭
bei	欮
yoi	欯
pfi	欰
aoi	欱
bboi	欲
win	欲
zmi	欳
adui	欴
ain	欴
fvdi	欵
jcsi	欶
vsi	欶
xxni	欷
ain	欸
uvdi	欸
dtoi	欹
vin	欹
kbi	欺
ffi	欻
uuui	欼
ain	欽
fvdi	款
yi	款
yrsi	款
dgi	欿
ngi	欿
trsi	歀
kbli	歁
kin	歁
klbi	歁
klri	歁
krli	歁
din	歂
eri	歂
etni	歂
ggi	歃
onbi	歄
qoi	歄
cyi	歅
ldi	歆
din	歇
dnbi	歇
dnli	歇
ain	歈
auri	歈
beei	歉
qin	歉
lhni	歊
lnoi	歊
loni	歊
qin	歊
lzri	歋
tiv	歌
toti	歌
wfi	歍
rci	歎
rci	歏
fi	歐
fooi	歐
fxi	歐
zhi	歑
lnji	歒
xin	歒
vin	歓
wvi	歓
zfei	歔
jin	歕
jrmi	歕
ydoi	歖
yobi	歖
yori	歖
ehi	歗
fffi	歘
aoei	歙
aci	歛
adei	歛
ain	歛
aooi	歛
asei	歛
oin	歛
fnci	歜
fybi	歝
fyi	歝
dwwi	歞
ein	歟
uuui	歠
rin	歡
rooi	歡
uin	歡
vin	歡
ze	止
eze	正
ez	正
zfl	此
zsp	步
eaxz	武
we	武
zju	歧
zzn	歨
zsp	歩
bez	歪
zff	歫
zza	歬
zya	歭
zzz	歮
zmu	歯
zui	歯
zgq	歱
eca	歲
zaqs	歲
zs	歲
zaqs	歳
lttz	歴
zfqu	歶
ldx	歷
ldy	歷
lhhz	歷
pbze	歸
pbzn	歸
pq	歸
reev	歸
ree	歸
rzen	歸
yee	歸
da	歹
zca	歺
dfl	死
ecf	死
dnm	歾
dnu	歿
dru	歿
dgn	殀
dpd	殀
dru	殁
dme	殂
dcn	殃
dcv	殃
dbm	殄
duo	殆
dpf	殈
dnd	殉
dsb	殊
dss	殊
daf	残
dkx	残
desi	殌
dsi	殌
duy	殌
dez	殍
dgn	殎
dajw	殏
dna	殏
djcs	殐
dvs	殐
djor	殑
dew	殔
dlo	殕
dje	殖
djl	殖
djme	殖
djml	殖
ddil	殗
ddql	殗
dxl	殗
daf	殘
daqq	殘
dkx	殘
dq	殘
dxd	殙
dkoe	殛
dwoe	殛
dst	殜
domb	殞
ddf	殟
dobf	殟
dpmd	殠
dbv	殡
dnkb	殡
dnpb	殡
dfnn	殢
drc	殣
dvdm	殤
dve	殤
dna	殥
dneb	殥
dnf	殦
dgl	殧
dlok	殧
dlsk	殧
dynd	殪
doj	殫
dooj	殫
deqe	殭
dac	殮
dae	殮
daob	殮
dase	殮
doa	殮
dbv	殯
dncb	殯
dnkb	殯
dnpb	殯
dnsb	殯
djm	殰
dyfb	殰
dym	殰
dbbe	殲
dgj	殲
rux	殳
foou	殴
fxru	殴
eru	段
eu	段
akru	殶
feyu	殷
pdnu	殷
pdyu	殷
xatu	殺
xta	殺
xtn	殺
xtru	殺
xu	殺
ynru	殻
yneu	殼
ynru	殼
ynr	殼
xxru	殽
xxuu	殽
hru	殾
ydru	殾
ypdu	殾
crbu	殿
cu	殿
giru	毀
gu	毀
gyru	毀
giru	毁
gyru	毁
lhnu	毃
lnou	毃
lonu	毃
qru	毃
coru	毄
lqru	毅
foou	毆
fxru	毆
gmru	毇
dapu	毈
eppu	毈
fypu	毈
fvdw	毉
ycrg	毊
ycro	毊
ygno	毊
ygo	毊
oxv	毋
oxx	毋
oxx	毌
oma	母
vom	毎
vox	毎
vm	每
vom	每
yox	毐
oma	毑
oxa	毑
hom	毒
hox	毒
voms	毓
bl	比
bhp	毖
qbl	毗
qbl	毘
noba	毚
ml	毛
bml	毞
dom	毠
mzo	毡
mco	毢
eem	毣
burm	毤
mnd	毥
rml	毦
maqj	毧
maqx	毧
msr	毨
mmn	毩
lhnm	毫
lmv	毫
lnm	毫
lonm	毫
majw	毬
mna	毬
dml	毭
mff	毯
mlo	毰
uuum	毲
mmm	毳
mrss	毴
dmm	毷
mqh	毸
aml	毹
aurm	毹
mai	毺
maur	毺
xium	毻
dml	毼
dnbm	毼
dnlm	毼
mew	毽
deem	毾
udmm	毿
umm	毿
uuum	毿
mgm	氀
mrdd	氁
qbpm	氂
yspm	氂
lqm	氃
mnbm	氄
mnrm	氄
snom	氅
mbd	氆
mbed	氆
mbod	氆
loom	氈
mzo	氈
ooom	氉
mloe	氊
mlom	氊
rnrm	氋
mufd	氌
mmvm	氍
xx	氏
xee	氐
oxx	民
fox	氓
kl	气
kz	气
kpp	氕
krp	氖
kri	氘
kei	氙
ksi	氚
kbd	氛
kdo	氜
knb	氝
kvj	氟
kii	氠
kiqi	氠
kpb	氡
kmn	氣
km	氣
kxx	氣
kod	氤
kco	氥
klh	氦
kbh	氧
kng	氨
kjor	氪
kesi	氫
ksi	氫
kui	氫
kuy	氫
koe	氬
kcs	氭
kjqs	氭
kff	氮
kcew	氯
kew	氯
khu	氰
kdem	氱
kdvm	氱
kep	氱
kdf	氲
kobf	氲
kdf	氳
kobf	氳
wn	水
wn	氶
awn	氷
un	永
zwn	氹
wdx	氻
wdy	氻
wbn	氼
wpl	氾
wkl	氿
wkx	氿
wkz	氿
wti	汀
wjj	汁
ajw	求
na	求
wbn	汃
wbn	汄
wkk	汅
bwn	汆
wua	汊
wna	汋
wsi	汌
wka	汍
wza	汍
wzx	汍
wra	汎
wdn	汏
wca	汐
wgl	汑
wfl	汒
wzj	汓
wvz	汔
wei	汕
ewn	汖
wgj	汗
wgj	汘
wuj	汙
wke	汚
wrk	汚
wzj	汛
wzx	汛
wol	汜
wgx	汝
iwn	汞
iwv	汞
wie	江
wal	池
wke	污
wrk	污
wju	汥
wxx	汦
wkj	汧
wdo	汨
wdo	汩
wke	汪
wjj	汫
jwn	汬
wnb	汭
wnb	汮
wnr	汮
wxu	汯
wda	汰
wad	汱
wpu	汲
wrn	汲
wlu	汳
wlp	汴
way	汵
wwx	汶
wpx	汷
wfy	汸
wxu	汹
bjn	決
wjn	決
wwj	汻
wsj	汼
wkl	汽
wkz	汽
wz	汽
wbd	汾
wui	汿
wui	沀
wha	沁
wki	沂
wgn	沃
wpd	沃
wta	沄
wrr	沅
wlr	沆
wur	沇
wkl	沈
wnr	沈
wnr	沉
kwn	沊
wak	沋
wel	沌
wde	沍
wpf	沎
wcd	沏
wtn	沐
wee	沑
wnu	沒
wru	沒
wdo	沓
wfk	沔
wtly	沔
wnm	沕
bci	沖
bcj	沖
wci	沖
wcj	沖
gnw	沗
pdw	沗
wbl	沘
wsp	沙
wze	沚
wjn	沛
wln	沛
wpi	沜
wpy	沜
wwn	沝
wen	沞
wtn	沞
wnu	沟
wei	沠
wen	沠
wru	没
wfp	沪
wqb	沫
wys	沫
wqb	沬
wys	沬
wat	沭
wme	沮
wlo	沯
wlo	沰
wnf	沱
wva	沲
wto	河
wbm	沴
wrs	沶
waxx	沷
wax	沷
wvj	沸
wvv	沸
wv	沸
wiq	油
wqo	沺
wuo	治
wdo	沼
wjo	沽
wzo	沾
wbo	沿
wro	沿
weo	泀
wyeo	泀
wor	況
wno	泂
wno	泃
wsl	泄
wob	泅
wsn	泆
wdo	泇
wpb	泈
pdw	泉
pv	泉
wpd	泊
whp	泌
wte	泍
wtj	泍
wvf	泎
wee	泏
weu	泏
wbd	泐
wwd	泑
wga	泒
wqu	泓
wgo	泔
wu	法
wyu	法
wdp	泖
wfo	泗
whj	泘
wpj	泙
wzf	泚
wbz	泛
wpaz	泛
wpz	泛
wxe	泜
wka	泝
wnt	泞
wez	泟
wap	泠
wat	泠
wnl	泡
wnol	泡
wpx	波
wle	泣
wua	泤
wub	泤
wcf	泥
waqi	泧
wak	注
wse	泩
wmo	泪
wlw	泫
wnb	泬
wpa	泭
wbj	泮
wox	泯
fnw	泰
wcn	泱
wjp	泲
wun	泳
wfe	泴
low	泵
wde	泹
wdk	泿
wza	洀
wyo	洁
wlf	洂
wlf	洃
wxf	洃
woo	洄
weny	洅
wtny	洅
wwe	洆
wod	洇
wnlp	洈
wnp	洈
wfo	洉
wxiz	洊
wbh	洋
wdr	洌
wre	洍
wpm	洎
wri	洏
wtnr	洏
wmii	洐
wmit	洐
wpad	洑
wco	洒
wjns	洓
wjn	洓
wya	洔
wbu	洕
woed	洖
wogn	洖
wokd	洖
wsr	洗
wrk	洘
wypk	洘
wsb	洙
wss	洙
wps	洚
wpo	洛
pow	洜
wng	洝
wneo	洞
wen	洟
wjqb	洟
wus	洠
wln	洡
wpe	洢
wmn	洣
wbk	洤
wej	津
wtd	洦
wxe	洧
wxu	洧
wlx	洨
wiqx	洩
wix	洩
wqx	洩
wrb	洪
wpf	洫
wrd	洬
wfk	洭
wra	洮
wrbb	洮
fdw	洯
hdw	洯
wff	洰
wrj	洱
wyyy	洲
wy	洲
wgo	洳
wbk	洴
wnd	洵
wnxu	洶
wxu	洶
wpe	洷
wser	洸
wede	洹
wco	洺
wgo	活
wyy	洼
wao	洽
wlk	派
wdrk	洿
wxk	洿
wfo	浀
wror	浀
wl	流
wts	流
wbed	浂
wbgn	浂
wgn	浂
wee	浄
wne	浄
waf	浅
wkx	浅
wea	浖
wua	浖
wajw	浗
wna	浗
wcm	浘
wjk	浙
whx	浚
wubp	浚
wurp	浚
wayo	浛
wkeb	浜
wpob	浜
wakm	浝
wam	浝
woz	浞
wpip	浟
wxxn	浠
wjnz	浡
wde	浢
wnrr	浣
wnxu	浤
wocl	浥
woc	浥
wajq	浦
wij	浦
wok	浧
wnt	浨
wso	浩
wadk	浪
wan	浪
wnbg	浫
wnrg	浫
wqe	浬
wtqx	浭
wtx	浭
wez	浮
wwo	浯
whr	浰
wfk	浱
wpf	浲
waxu	浳
wbbo	浴
wwo	浴
wnam	浵
wnlm	浵
wns	浶
wm	海
wvom	海
wenu	浸
wrx	浸
wgn	浹
whc	浺
wnbo	浻
wnro	浻
wdcr	浼
wel	浼
wncr	浼
weg	浽
wyf	浾
wmb	浿
wmr	涀
wtm	涁
bat	涂
bbh	涂
wat	涂
wbh	涂
whv	涂
wot	涃
wiqk	涄
wdy	涅
wgi	涅
wdg	涆
wesi	涇
wsi	涇
wui	涇
wuy	涇
wsu	消
wzs	涉
wdah	涊
wnad	涋
wtj	涌
wtnq	涌
wypz	涍
wpzw	涎
wkw	涏
wix	涐
wjcs	涑
wvs	涑
weo	涒
wou	涓
weay	涔
wbqp	涕
wtp	涕
wpl	涖
wbor	涗
wan	涘
wuvd	涘
wfad	涙
wmo	涙
wbor	涚
wfa	涛
wlo	涪
wnb	涫
wybg	涬
wyj	涬
wenu	涭
wcnr	涮
wlyy	涯
wuuu	涰
wek	涱
wlpu	液
wlx	液
wnbi	涳
wnri	涳
wncp	涴
wkbu	涵
wwbu	涵
wwu	涵
wge	涶
wgjy	涶
wgry	涶
wcs	涷
wjqs	涷
wojo	涸
whg	涹
wcjo	涺
wbgo	涻
wbo	涻
wbyo	涻
blos	涼
bls	涼
wlos	涼
wls	涼
wsv	涼
wxd	涽
wwd	涾
weqa	涿
weq	涿
wnez	淀
wnz	淀
wlg	淁
wdea	淂
wdua	淂
wbnp	淃
wpl	淃
wsq	淄
wtk	淅
wxxu	淆
wxx	淆
wkb	淇
wcee	淈
wceu	淈
wqt	淉
wdg	淊
wng	淊
wtt	淋
wsno	淌
wno	淍
wnyo	淍
wfnq	淎
wded	淏
wdgn	淏
wdd	淐
su	淑
wfsu	淑
wjeg	淒
wjg	淒
wrf	淓
wje	淔
wjl	淔
wjme	淔
wjml	淔
wqu	淕
wyby	淕
wye	淕
wyry	淕
wqj	淖
wzdj	淖
wnm	淗
wni	淘
wnwu	淘
wnrs	淙
wns	淙
wfad	淚
wmo	淚
wsnr	淛
wuu	淜
wucl	淝
wuc	淝
wtbu	淞
wfb	淟
wrob	淟
wqer	淠
wff	淡
waqe	淢
whe	淢
wgr	淣
wfbb	淤
wcew	淥
wae	淦
wnhp	淧
bne	淨
wee	淨
wne	淨
wybp	淩
wyrp	淩
wyx	淩
wam	淪
wbf	淪
wek	淫
wjj	淬
wft	淭
wve	淮
wtu	淯
wayh	淰
wnbt	深
wnn	深
wnrt	深
wzr	淲
wlhz	淳
wloz	淳
wlz	淳
wnmh	淴
whi	淵
whp	淵
wmr	淵
wrm	淵
wln	淶
wdb	混
whnl	淸
whu	淸
wdil	淹
wdql	淹
wxl	淹
waf	淺
waqq	淺
wkx	淺
wqv	淺
wedf	添
wedh	添
wgnf	添
wgnh	添
wpdf	添
wpdh	添
www	淼
wrz	淽
awn	淾
wpdn	淿
wpj	淿
wdjr	渀
www	渁
wdw	渂
wro	渃
wrxo	渃
wrss	渄
whu	清
wbkr	渆
wdl	渇
wdnf	渇
wwh	済
wzs	渉
whi	渊
wmr	渊
wrm	渊
wcew	渌
wew	渌
wpg	渒
wpqg	渒
wudm	渗
wum	渗
wuum	渗
wmt	渘
wnc	渙
wnfb	渙
wnnd	渙
who	渚
wypd	渚
baqo	減
bko	減
waqo	減
wko	減
wrd	渜
wtnd	渜
wai	渝
waur	渝
wbtm	渞
who	渞
wlht	渟
wlnt	渟
wlot	渟
wfft	渠
du	渡
wlru	渡
wrc	渢
wrx	渢
wtde	渣
wtm	渣
wjnd	渤
wcp	渥
wonb	渦
wqo	渦
wlnn	渧
wqk	渨
wdf	温
wobf	温
wpcu	渪
wst	渫
wmbr	測
wr	測
wqu	渭
wrto	渮
whl	港
wrbl	港
wrbp	港
waor	渰
wci	渱
wnee	渲
wne	渲
wqr	渳
wdl	渴
wdnl	渴
wrq	渵
wrc	渶
wfj	游
wfvz	游
wni	渹
wms	渺
wsm	渻
wbkd	渼
wjao	渽
wnc	渾
wtrs	渿
wjed	湀
wjgn	湀
wkn	湀
wjao	湁
wok	湂
wook	湂
whf	湃
wcm	湄
wcs	湅
wjqs	湅
wld	湆
wlu	湇
wgt	湈
whgo	湉
bfnd	湊
bfn	湊
wfnd	湊
wfnn	湊
wfn	湊
wwj	湋
wwos	湋
wxn	湌
wdi	湍
wer	湍
wetr	湍
wtoh	湎
wta	湏
wtmb	湏
wtpd	湐
wfbu	湑
wyzu	湑
wor	湒
wbdf	湓
wber	湔
wbi	湔
wew	湕
wfu	湖
wjou	湖
wyya	湗
wtm	湘
wlfd	湙
wpwl	湚
wrwu	湚
wkbl	湛
wklb	湛
wklr	湛
wkl	湛
wkrl	湛
wkv	湛
wdez	湜
wjn	湜
wbpd	湝
wzmb	湞
wpdk	湟
welf	湠
wexf	湠
wqnu	湡
weoq	湢
woxd	湣
wfva	湤
wnbd	湥
wnrd	湥
wds	湦
wtd	湧
wtnd	湧
wtqd	湧
wmad	湨
wgq	湩
wceq	湪
weq	湪
whf	湫
hfw	湬
wbe	湭
wcy	湮
wdem	湯
wdvm	湯
wep	湯
wpes	湰
wps	湰
wflo	湱
wfxo	湱
whlo	湱
whxo	湱
wegu	湲
wex	湲
wjng	湳
wnj	湳
wbee	湴
wbe	湴
wbo	湴
wbkb	湵
wbkn	湵
wbks	湵
wbku	湵
wpdw	湶
wfnd	湷
wlhr	湸
wlnr	湸
wlor	湸
wlq	湹
wld	湻
wlod	湻
wlfq	湾
wq	湾
m	満
wrne	満
wrnu	満
wbwf	溈
wewf	溈
wwa	溈
wywf	溈
wdl	溉
wduk	溉
wg	溉
wlv	溉
wpdk	溉
wefd	溍
weud	溍
wtyy	溎
wleo	溏
wlps	源
wya	源
wsmb	溑
wyok	溒
wbef	溓
wqn	溓
wbkf	溔
bve	準
wvj	準
wgfs	溗
wce	溘
wyuf	溘
wfnw	溙
wrao	溚
wro	溚
wnbg	溛
wnrg	溛
wddq	溜
woq	溜
wje	溝
wjny	溝
wnu	溝
wuac	溞
wubc	溞
wndl	溟
wbhi	溠
wbki	溠
wdya	溡
wbef	溢
wye	溢
wpam	溣
wmf	溤
waja	溥
wia	溥
weep	溦
werp	溦
wct	溧
wjat	溨
wwf	溩
ce	溪
wewd	溪
wdf	溫
wobf	溫
wbku	溬
wpbn	溮
wren	溮
wbeu	溯
wed	溰
wfnh	溱
wgiu	溲
wgu	溲
womb	溳
wpmd	溴
wfeu	溵
wpdu	溵
wnbo	溶
wnw	溶
woeq	溷
whs	溸
wjns	溹
wqbb	溺
wqmm	溺
wdee	溻
wewy	溼
wfka	溽
wpqu	溾
wpru	溾
wva	溾
wqb	溿
wlwq	滀
wbbh	滁
wgy	滂
wlnf	滂
wbue	滃
wado	滄
wbp	滄
efn	滅
waqf	滅
weot	滆
wjb	滇
wjmb	滇
wlho	滈
wlno	滈
wloo	滈
wqo	滈
wdsr	滉
wkm	滊
wbew	滋
wlww	滋
wrww	滋
ww	滋
wpit	滌
wpn	滌
wpt	滌
wec	滍
weec	滍
ffnw	滎
wba	滏
wbxa	滏
wbxe	滏
wcst	滐
wct	滐
wqu	滑
wtoo	滒
wnl	滓
weg	滔
ubnw	滕
wldk	滖
wnbo	滘
wnro	滘
wfv	滙
wlbk	滚
wluk	滚
wewu	滛
wuu	滛
wuwu	滛
wpdj	滜
wlil	滝
wlql	滝
wfko	滣
wlft	滦
wbv	滨
wnkb	滨
wnpb	滨
wuv	滩
wpiu	滫
wfoc	滬
wfol	滬
wfp	滬
wqjq	滭
wqj	滭
wqrj	滭
wqrq	滭
wzrm	滮
wfnn	滯
wsnn	滯
wldr	滰
wnru	滱
wudm	滲
wum	滲
wuum	滲
wlno	滳
wxo	滳
wlno	滴
wxo	滴
wnhe	滵
whnp	滶
wyfp	滶
wzoa	滷
wzof	滷
wzox	滷
wiw	滸
wzh	滹
wpih	滺
wlps	滻
wwls	滻
wtta	滼
wttz	滼
wleq	滽
wlbk	滾
wlok	滾
wlrk	滾
wluk	滾
m	滿
wrnb	滿
ycrw	漀
ywn	漀
wuf	漁
wcrs	漂
ws	漂
wnfu	漃
wely	漄
wsqt	漅
wgw	漆
wtbw	漆
wtw	漆
wmiz	漇
wjrs	漈
wlb	漉
wmg	漊
wbps	漋
wrc	漌
woae	漍
woh	漍
wmiz	漎
wcu	漏
ybgw	漐
yzw	漐
wadk	漑
wdl	漑
wduk	漑
wpdk	漑
wqoc	漒
wquc	漒
wla	漓
wlxu	漓
wwuu	漓
wna	演
wneb	演
wrfd	漕
wrod	漕
wpa	漗
wpoh	漗
wfku	漘
wcua	漙
wjqa	漙
wqa	漙
wxa	漙
wfoo	漚
wbnw	漛
wtty	漜
weed	漝
wemr	漞
wsny	漟
wdv	漠
wrdd	漠
wvdm	漡
wve	漡
wrc	漢
wux	漢
wcw	漣
wnby	漥
wnry	漥
qbpw	漦
yspw	漦
wjdz	漧
wjvz	漧
wpfw	漨
wfvz	漩
wzv	漩
wqdo	漪
wqv	漪
wdfu	漫
wmx	漫
whmb	漬
wrar	漭
wrdr	漭
wlew	漮
wqs	漯
weuu	漰
wjci	漱
wvsi	漱
wk	漲
wqek	漲
wqk	漲
wldj	漳
wens	漴
watp	漵
wbhp	漵
wcch	漶
wlhb	漷
wlob	漷
wlzb	漷
wck	漸
wezf	漹
wdxx	漺
wjxb	漺
weem	漻
wem	漻
wev	漼
wcws	漽
wbku	漾
wbkw	漾
gcw	漿
geaw	漿
guaw	漿
wfpb	潀
wfq	潀
wpfk	潀
wpfq	潀
fwtb	潁
fwt	潁
webe	潂
webo	潂
web	潂
wmiu	潃
wjcp	潄
wvsp	潄
watu	潊
wbhu	潊
wbx	潎
wsnp	潎
wmno	潏
wvf	潐
waxu	潑
wfx	潑
wjk	潑
wjqu	潑
wncq	潒
wnn	潒
wch	潓
wcuh	潓
wjqh	潓
wfds	潔
whds	潔
wyo	潔
wek	潕
wgl	潕
wvff	潕
wvt	潗
wmq	潘
wbwf	潙
wewf	潙
weh	潚
kd	潛
wkkd	潛
wqnd	潛
wqad	潜
wqnd	潜
waoe	潝
wlo	潞
wozo	潞
wgnf	潟
wflb	潠
wolb	潠
wlhp	潡
wlop	潡
wlzp	潡
wka	潢
wreb	潢
wrqb	潢
wmw	潣
wmk	潤
wcm	潥
wdbs	潦
wla	潦
wbo	潧
wbqd	潧
wqrb	潩
wvdd	潪
wbns	潫
woj	潬
wooj	潬
wcdj	潭
wxj	潭
wjdu	潮
wju	潮
wea	潯
weia	潯
wceb	潰
wqa	潰
wynd	潱
whsu	潲
wch	潳
wcyd	潳
wqh	潴
wqyd	潴
wrup	潵
wrx	潵
wqf	潶
wze	潷
wttu	潸
wttt	潹
wczz	潺
whbw	潻
wlq	潼
wbd	潽
wbed	潽
wbod	潽
wmcs	潾
wmc	潾
wows	潿
wow	潿
wdaz	澀
wzzz	澁
weep	澂
wekp	澂
wjd	澄
weqe	澅
wqer	澆
wyr	澆
wyyr	澆
wffd	澇
wrnd	澇
wtup	澈
wtx	澈
wirp	澉
wtrp	澉
wdls	澋
wkbk	澌
wyda	澍
wyoa	澍
wmv	澎
wydm	澎
wyom	澎
wooe	澏
wut	澐
wefq	澑
werq	澑
woq	澑
wxq	澑
wyfq	澑
witb	澒
wit	澒
wmip	澓
wmiv	澓
wpdo	澔
waj	澕
wrjq	澕
wrrj	澕
wrrq	澕
wmt	澖
wmd	澗
wzod	澞
wloh	澟
wlos	澟
wxl	澠
wlt	澡
woot	澡
wsnq	澢
wso	澢
wjbg	澣
wjdg	澣
wcn	澤
wfyg	澤
wfy	澤
wuq	澤
wnds	澥
wua	澦
wutb	澦
wut	澦
wfd	澧
wrod	澧
wzw	澨
snw	澩
wuap	澪
wuat	澪
wrqu	澫
wbib	澬
wrib	澬
wlwv	澭
wad	澮
waqd	澮
wzcm	澯
wae	澰
waob	澰
woa	澰
wcru	澱
wnez	澱
wfel	澲
wfet	澲
wfs	澲
au	澳
wpnd	澳
wpob	澳
wfek	澴
won	澴
wli	澵
wltk	澵
wloe	澶
wlom	澶
wdff	澷
waqh	澸
wkh	澸
wnli	澹
wvo	澹
wldh	澺
wbew	澻
wcog	澼
wcol	澼
wpj	澼
wzeq	澽
wzn	澽
wybw	澾
wyw	澾
wtts	澿
wpdp	激
wp	激
wca	濁
wc	濁
wfnc	濁
wlbf	濂
wlq	濂
wffk	濃
wnk	濃
wrok	濃
wttk	濃
wqow	濄
wja	濆
wjrb	濆
wwoo	濇
worq	濈
wmv	濉
wzas	濊
wttz	濋
gqwd	濌
wrnh	濍
wmd	濎
wkkh	濏
wkkx	濏
wdh	濐
wdyd	濐
wlpf	濓
wlpq	濓
wlqp	濓
wlq	濓
wrx	濔
wdfe	濕
wdwf	濕
wf	濕
wfh	濖
wfyd	濖
wrdn	濗
wnht	濘
wnt	濘
wfff	濙
wrnf	濙
wfft	濚
wrnt	濚
wrnq	濛
weff	濜
wkbs	濝
wpmr	濞
wwh	濟
wwr	濟
wlhq	濠
wlnq	濠
wloq	濠
wqv	濠
wur	濡
wutr	濡
weej	濢
wjbd	濣
wjdd	濣
wfa	濤
wyya	濤
wcn	濥
weih	濦
waa	濧
wfa	濧
wfea	濧
wbeh	濨
wlwh	濨
wrwh	濨
wrvu	濩
whnc	濪
whnl	濪
whuc	濪
whul	濪
wrf	濫
wrvf	濫
wznm	濬
wrc	濭
wryf	濭
wpfb	濮
wpfd	濮
wpv	濮
weev	濯
wsv	濰
wbv	濱
wncb	濱
wnkb	濱
wnpb	濱
wnsb	濱
wynu	濲
wsrd	濳
wffw	濴
wncb	濵
wnsb	濵
wmgo	濶
wwrb	濷
wmbk	濺
wmbq	濺
wbcb	濻
wbq	濻
wfs	濼
wrn	濼
wwpt	濼
wqab	濽
wqnb	濽
wh	濾
wzh	濾
wzqh	濾
wlru	濿
wtdp	瀀
wtmp	瀀
wyx	瀀
wbha	瀁
wbhk	瀁
wbkx	瀁
wufd	瀂
wmbe	瀃
wmbm	瀃
wzdp	瀄
wffa	瀅
wrna	瀅
wjm	瀆
wjyd	瀆
wxbd	瀆
wyfb	瀆
wym	瀆
wlk	瀇
wlrb	瀇
weec	瀈
wngf	瀉
wnke	瀉
wzrf	瀊
wnii	瀋
wni	瀋
wnmq	瀋
wlbf	瀌
wlqy	瀍
wrfa	瀎
wrfb	瀎
wrfe	瀎
wrfv	瀎
wddr	瀏
woar	瀏
wwr	瀏
wjae	瀐
wdrw	瀑
wmip	瀓
wynu	瀔
wzsb	瀕
wzst	瀕
wuv	瀖
wnfh	瀗
wnhh	瀗
wzqf	瀘
wll	瀙
wltr	瀙
wjbe	瀚
wjde	瀚
wfua	瀛
wfuz	瀛
weoc	瀜
wld	瀝
wlhz	瀝
whne	瀞
whue	瀞
wreh	瀟
wffs	瀠
wbxw	瀡
wcew	瀢
wqw	瀢
wzce	瀣
wlfk	瀤
weeo	瀥
weeq	瀥
weqd	瀦
weqh	瀦
wqh	瀦
wqyd	瀦
wakp	瀧
wal	瀧
wlul	瀧
wjcb	瀨
wvsb	瀨
whrb	瀩
whrt	瀩
vomw	瀪
wynu	瀫
wjcb	瀬
wjct	瀬
wvsb	瀬
wvst	瀬
wffo	瀯
wqns	瀰
wqr	瀰
wflr	瀱
waop	瀲
wap	瀲
wop	瀲
wrlf	瀳
wmbg	瀴
wsg	瀴
wmqb	瀵
wrvo	瀶
weeb	瀷
wbbe	瀸
waom	瀹
wnoa	瀺
wjab	瀻
wln	瀼
wlok	瀼
wnjz	瀽
wbs	瀾
wmcs	瀾
wmjs	瀾
wmn	瀾
wvos	瀿
wvs	瀿
wutm	灀
wmpw	灁
wefa	灂
wfd	灃
wffd	灃
wrod	灃
wrrr	灄
wqqy	灅
wrrf	灆
wfeu	灇
wfru	灇
wmmv	灈
wsov	灉
wkkt	灊
wlku	灋
wre	灌
wrov	灌
wmbi	灍
wco	灑
wla	灑
wllb	灑
wsrb	灒
issw	灓
lfw	灓
sisw	灓
wfdc	灔
wfdl	灔
wroc	灔
wrol	灔
wlv	灕
wlxv	灕
wwuv	灕
wlts	灖
wcle	灗
wclm	灗
wrcv	灘
wuv	灘
wsnf	灙
wsnr	灚
wmoj	灛
wmo	灛
wdlb	灝
wdlt	灝
wuru	灞
wcwc	灟
wrfr	灠
wrvr	灠
wvl	灠
wrms	灡
wrm	灡
wjck	灢
wvnk	灢
wisq	灣
wlfq	灣
wq	灣
wsiq	灣
wsk	灣
wist	灤
wsit	灤
pdww	灥
wdwb	灦
wdwt	灦
wfdc	灧
wfdl	灧
wffc	灧
wffl	灧
wldb	灨
wfdc	灩
wfdf	灩
wffc	灩
wfff	灩
wroc	灩
wrof	灩
wtwm	灪
fn	火
frl	灮
fti	灯
lfn	灰
xfn	灰
fdp	灱
fri	灲
nfn	灳
fie	灴
efn	灵
ef	灵
fye	灶
frj	灷
nnf	灸
fgl	灹
fal	灺
yfn	灻
fna	灼
nfn	災
sfn	災
nfn	灾
kfa	炁
fbu	炂
bdf	炃
fee	炄
dfn	炅
fwx	炆
fpx	炇
fru	炈
ffp	炉
fin	炊
fba	炋
fbr	炌
flu	炍
ffn	炎
ffn	炏
ffj	炐
ftn	炑
fsp	炒
fdj	炓
fjn	炔
flr	炕
fel	炖
fki	炘
ufn	炙
dfn	炚
fde	炟
fqi	炠
fez	炡
fat	炢
fto	炣
fdo	炤
fvj	炥
fva	炧
fnf	炨
fap	炩
fat	炩
fee	炪
feu	炪
flw	炫
fff	炬
elf	炭
exf	炭
fnl	炮
fnol	炮
fnbo	炯
fno	炯
fnro	炯
nfa	炰
nolf	炰
uof	炱
fuo	炲
fenb	炳
fen	炳
ftnb	炳
fcn	炴
fpb	炵
fzo	炶
fak	炷
fvf	炸
zof	点
bf	為
bwf	為
ewf	為
uwf	為
wa	為
for	炾
flx	烄
fpf	烅
fmii	烆
fmit	烆
fbk	烇
drf	烈
fbh	烊
ptf	烋
fpt	烌
fsr	烍
ggf	烎
kfn	烎
wfa	烏
fza	烐
fra	烑
frbb	烑
faxi	烒
fyy	烓
fneo	烔
aqpf	烕
aqvf	烕
jaqf	烖
flh	烗
frb	烘
fpo	烙
fao	烚
fca	烛
fede	烜
wef	烝
ftp	烞
fod	烟
fxe	烠
fxu	烠
frb	烡
fng	烢
flf	烣
fxf	烣
frk	烤
fypk	烤
drf	烮
fxxn	烯
fez	烰
fnbo	烱
fnro	烱
jkf	烲
fajq	烳
fij	烳
fesi	烴
fsi	烴
fui	烴
fuy	烴
frna	烵
frne	烵
fkw	烶
fnrr	烷
fvom	烸
lhwf	烹
lowf	烹
lwf	烹
fadk	烺
fan	烺
fpzw	烻
feq	烼
fpf	烽
ffy	烾
fnam	烿
fnlm	烿
fbbo	焀
fwo	焀
oif	焁
pipf	焂
fyf	焃
eof	焄
fou	焆
fsu	焇
fflf	焈
folf	焈
ezkf	焉
fdg	焊
gyf	焋
fhx	焌
fubp	焌
furp	焌
fbqp	焍
ftp	焍
jkf	焎
kouf	焏
wouf	焏
fwo	焐
fayo	焓
fcyo	焗
fono	焗
flo	焙
ttf	焚
mfn	焛
fdb	焜
fxd	焝
flhz	焞
floz	焞
flz	焞
frd	焟
fjj	焠
ekl	無
gll	無
vff	無
vf	無
fnbi	焢
fnri	焢
ruf	焣
lpaf	焤
fncp	焥
vfa	焦
fbuh	焧
fdu	焨
fnbq	焪
fnrq	焪
frnb	焫
fdnm	焬
fep	焬
ffnr	焭
rnr	焭
fki	焮
fqj	焯
fzdj	焯
fdg	焰
fng	焰
fff	焱
flpu	焲
flx	焲
fve	焳
ftu	焴
fnbe	焵
eadf	然
jfa	然
nbaf	然
nraf	然
uadf	然
fpg	焷
fpqg	焷
ddf	焸
fdx	焺
fkbl	煁
fklb	煁
fklr	煁
fkl	煁
fkrl	煁
frc	煂
fdyy	煃
fgq	煄
feru	煅
fofu	煆
fox	煆
fnc	煇
crc	煈
fcs	煉
fjqs	煉
fnee	煊
fne	煊
fds	煋
fpdk	煌
fhf	煍
beuf	煎
bfa	煎
feoq	煏
frc	煐
hfn	煑
ydf	煑
ypaf	煑
ypdf	煑
fwj	煒
fwos	煒
fdi	煓
fer	煓
fetr	煓
ffzo	煔
fegu	煖
fex	煖
frd	煗
ftnd	煗
faqo	煘
fko	煘
fcy	煙
fod	煙
dfff	煚
mmf	煛
fdl	煜
fcm	煝
nepf	煞
fqu	煟
fst	煠
few	煡
ffna	煢
ffnj	煢
ffnx	煢
ffnz	煢
fmt	煣
fgt	煤
fnc	煥
fnfb	煥
fnnd	煥
fnob	煥
dnof	煦
ddof	照
df	照
fqk	煨
fta	煩
ftmb	煩
fbe	煪
fbeq	煫
fdem	煬
fdvm	煬
fep	煬
sdrf	煭
hfa	煮
ypaf	煮
ypdf	煮
fbpd	煯
fooo	煰
potf	煲
fdf	煴
fobf	煴
ffm	煸
fleo	煻
fnee	煼
ffee	煽
fodh	煾
faja	煿
fia	煿
fdsr	熀
fddu	熁
fkm	熂
mpdf	熃
fpmh	熄
fdf	熅
fobf	熅
fce	熆
fyuf	熆
flho	熇
flno	熇
floo	熇
fqo	熇
prff	熈
prof	熈
fomb	熉
ufa	熊
uf	熊
uuff	熊
ufn	熋
uuff	熋
fmb	熌
fnoo	熍
fewu	熎
fuu	熎
fuwu	熎
gqf	熏
fndl	熐
fbef	熑
fqn	熑
ffnf	熒
rnf	熒
fnbo	熔
fnw	熔
fado	熗
rflf	熙
rolf	熙
fqjq	熚
fqj	熚
fqrj	熚
fqrq	熚
fcrs	熛
fboh	熜
fpa	熜
fpoh	熜
flb	熝
fruy	熞
lf	熟
lhzf	熟
lozf	熟
lzzf	熟
feed	熠
fmg	熡
fpfw	熢
fev	熣
feel	熤
ftnw	熥
ftn	熥
ftw	熥
fsv	熦
mibf	熧
caf	熨
crsf	熨
ffoc	熩
ffol	熩
fhcc	熪
flrf	熫
hnpf	熬
yfpf	熬
ffef	熭
hhef	熭
feem	熮
fem	熮
frc	熯
ffoo	熰
jzf	熱
ybyf	熱
yf	熱
yryf	熱
yzf	熱
fftb	熲
fft	熲
fdfu	熳
fmx	熳
flno	熵
fxo	熵
fdeu	熶
fdru	熶
fbo	熷
fbqd	熷
fkkd	熸
ydof	熹
yobf	熹
yorf	熹
fydo	熺
fyoo	熺
faoe	熻
fqrb	熼
feh	熽
flad	熾
fob	熾
fka	熿
freb	熿
foj	燀
fooj	燀
faj	燁
fpfj	燁
frjq	燁
frrj	燁
frrq	燁
fcdj	燂
fxj	燂
feaf	燃
fjf	燃
fnbf	燃
fnrf	燃
fuaf	燃
dgff	燄
ngff	燄
quff	燅
ybyf	燅
yff	燅
yryf	燅
fgi	燆
fgno	燆
fgo	燆
fpdo	燆
fbea	燇
fjd	燈
fti	燈
fel	燉
flhp	燉
flop	燉
flzp	燉
ffft	燊
fvf	燋
fja	燌
fjrb	燌
fdbs	燎
fla	燎
fmno	燏
fmcs	燐
fmc	燐
flq	燑
fqer	燒
fyr	燒
fyyr	燒
txxf	燓
fmq	燔
rfof	燕
rfv	燕
roff	燕
feia	燖
fmw	燘
wdef	燙
wdvf	燙
wef	燙
ffff	燚
fiff	燛
rrf	燛
fmh	燜
ffno	營
ff	營
fov	營
rnoo	營
snoo	營
fpnd	燠
fpob	燠
fcn	燡
ffyg	燡
ffy	燡
snf	燢
floh	燣
flos	燣
frqu	燤
flt	燥
foot	燥
fei	燦
fzcm	燦
fbew	燧
fbki	燨
fbx	燨
fpdp	燩
frnh	燪
flbf	燫
flq	燫
fgiu	燬
fgyu	燬
fca	燭
ffnc	燭
fifp	燮
fifu	燮
iffu	燮
fuap	燯
fuat	燯
fenp	燰
fhx	燰
fldh	燱
fddb	燲
fddf	燳
fad	燴
faqd	燴
fbt	燴
fur	燸
futr	燸
eqef	燹
flht	燺
flnt	燺
flot	燺
fqt	燺
fgqf	燻
fcnb	燼
feff	燼
fyya	燽
faf	燾
yyif	燾
feev	燿
fyff	爀
frf	爁
frvf	爁
snf	爂
ffft	爃
flru	爄
fqfy	爅
fdrw	爆
fw	爆
rybf	爇
ryrf	爇
ryzf	爇
fzqh	爈
flbf	爊
fgqd	爋
fgqf	爋
flk	爌
flrb	爌
ffs	爍
fpdt	爍
frn	爍
fwpt	爍
flhz	爏
ffp	爐
fzqf	爐
frvf	爑
nbfl	爒
nbfs	爒
ufds	爒
ufl	爒
fmng	爓
fbkk	爔
fbkr	爔
fiff	爕
ifff	爕
fal	爖
flul	爖
fda	爗
fdrq	爗
fln	爙
flok	爙
faom	爚
fbs	爛
fmcs	爛
fmjs	爛
fmn	爛
ffeu	爜
ffru	爜
fefa	爝
fccc	爞
fre	爟
frov	爟
fmmv	爠
frqc	爡
lttf	爢
fsnf	爣
frms	爤
frm	爤
fcwc	爥
frfr	爦
frvr	爦
fvl	爦
fuow	爧
sntf	爨
ftwm	爩
ei	爪
en	爪
ecl	爬
eej	爭
nej	爭
enl	爮
enol	爮
egu	爰
ex	爰
bwf	爲
ewf	爲
efaa	爵
efda	爵
bxx	父
bxcl	爸
bxc	爸
bxcc	爹
bxp	爺
bxrb	爺
xxx	爻
xxm	爼
dxxx	爽
jxxb	爽
nsa	爾
rx	爾
gi	爿
gp	爿
gtn	牀
gto	牁
gbh	牂
gado	牄
gwoo	牆
pi	片
py	片
plu	版
pbj	牉
pdo	牊
paqq	牋
pkx	牋
pg	牌
ppg	牌
ppqg	牌
pnqh	牎
pai	牏
paur	牏
pgg	牐
pfm	牑
pst	牒
pgy	牓
plnf	牓
ppa	牕
ppoh	牕
pfaq	牖
pfi	牖
pjm	牘
pjyd	牘
pxbd	牘
pyfb	牘
pym	牘
xp	牙
yp	牙
snox	牚
snoy	牚
sj	牛
sfl	牝
sdx	牞
sdy	牞
usj	牟
sal	牠
sye	牡
nsj	牢
sda	牣
sdn	牣
sfy	牥
sml	牦
spx	牧
slr	牨
snm	物
ssj	牪
sjp	牬
sfo	牭
paxs	牮
sjo	牯
siq	牰
sse	牲
som	牳
sxe	牴
bns	牶
sbk	牷
snz	牸
sya	特
sco	牺
sakm	牻
sesi	牼
ssi	牼
suy	牼
dns	牽
ls	牽
lwns	牽
swo	牾
sso	牿
cws	犀
hds	犁
hrs	犁
hds	犂
slo	犃
sdto	犄
svo	犄
snbe	犅
sje	犆
sjl	犆
sjme	犆
sjml	犆
sss	犇
sbnl	犈
sbnp	犈
spl	犈
slhz	犉
sloz	犉
slz	犉
smeb	犋
sofu	犌
sox	犌
sew	犍
yyas	犎
shd	犐
smad	犑
slho	犒
slno	犒
sloo	犒
sqo	犒
snee	犓
skm	犔
srlq	犕
srpq	犕
ffns	犖
rns	犖
snfo	犗
snho	犗
ltts	犘
sum	犙
suum	犙
cas	犚
crss	犚
qbps	犛
ysps	犛
slq	犝
sgi	犞
sgno	犞
sgo	犞
spdo	犞
slru	犡
sjm	犢
sjyd	犢
sxbd	犢
syfb	犢
sym	犢
ssfs	犣
ssl	犣
ssos	犣
sfuf	犤
sfu	犤
slbf	犥
sdrw	犦
sbkk	犧
sbkr	犧
sbk	犧
sbr	犧
sco	犧
vvs	犨
hgps	犩
hgvs	犩
sbep	犪
sbtp	犪
shzp	犪
ivvs	犫
vivs	犫
adn	犬
axx	犮
ax	犮
qpl	犯
qkl	犰
qkx	犰
qkz	犰
qka	犱
qza	犱
qzx	犱
qup	犲
qgj	犴
qvz	犵
biad	状
gad	状
qak	犹
qlr	犺
qjn	犻
qln	犻
qzl	犼
qxp	犽
qyp	犽
qad	犾
qlp	犿
gad	狀
qur	狁
qke	狂
qee	狃
qfn	狄
qke	狅
qci	狆
qcj	狆
qtn	狇
qbe	狉
mad	狊
qrs	狋
qse	狌
qnl	狍
qnol	狍
qqi	狎
qva	狏
qga	狐
qgn	狐
qap	狑
qat	狑
qvj	狒
qpx	狓
qcf	狔
qnb	狖
qno	狗
qaqi	狘
qme	狙
qde	狚
qpd	狛
qjo	狜
qede	狟
qdk	狠
qlx	狡
qpo	狢
qra	狣
qrbb	狣
qyo	狤
qnd	狥
qme	狦
qnj	狦
qnnr	狦
qgo	狧
qaqj	狨
qaqx	狨
qna	狩
qneo	狪
qypf	狫
qca	独
qc	独
qgn	狭
qat	狳
qbh	狳
qby	狴
qakm	狵
qam	狵
qxxn	狶
qou	狷
qqe	狸
bfg	狹
qgn	狹
qio	狺
qhx	狻
qubp	狻
qurp	狻
qadk	狼
qan	狼
qmb	狽
qjk	狾
qpzw	狿
qws	猀
qhr	猁
qdg	猂
rssd	猆
qzr	猇
qpg	猈
qpqg	猈
qgr	猊
adad	猋
lad	猌
qrd	猎
qfu	猏
qbkr	猐
qdb	猑
duad	猒
qqt	猓
qdd	猖
qdto	猗
qvo	猗
qsnr	猘
qee	猙
qne	猙
qve	猚
qzf	猛
qhu	猜
qjj	猝
qbgo	猞
qbo	猞
qbyo	猞
qfu	猢
qjou	猢
qxup	猣
qjed	猤
qjgn	猤
qkn	猤
qqk	猥
qrc	猦
qqo	猧
qegu	猨
qex	猨
qds	猩
qho	猪
qyd	猪
qypd	猪
qrq	猫
qqu	猬
qceq	猭
jnbd	献
nad	献
qdi	猯
qer	猯
qetr	猯
qfdd	猰
qhdd	猰
qmt	猱
qdl	猲
qdnl	猲
qofu	猳
qox	猳
qpfd	猴
qfm	猵
qak	猶
qbe	猶
bead	猷
qcm	猸
qewu	猺
quu	猺
quwu	猺
qzes	猻
qzps	猻
qzs	猻
qaja	猼
qia	猼
qqu	猾
qyok	猿
qgiu	獀
qgu	獀
qmf	獁
qlps	獂
qya	獂
edad	獃
qiad	獄
qnv	獅
qpbn	獅
qren	獅
qyen	獅
qpdj	獆
qfnh	獉
qado	獊
qpmj	獋
qdfu	獌
qmx	獌
qldr	獍
gcd	獎
gc	獎
gead	獎
guad	獎
qrdd	獏
qldj	獐
qck	獑
hnpd	獒
yfpd	獒
qhnp	獓
qyfp	獓
qpdj	獔
qlbi	獗
bad	獘
snsd	獘
qbx	獙
qsnp	獙
qka	獚
qreb	獚
qfb	獛
qfed	獛
qvn	獛
qmno	獝
qlq	獞
qyr	獟
qyyr	獟
qdbs	獠
qla	獠
qgnf	獡
qgi	獢
qgno	獢
qgo	獢
qpdo	獢
qpdp	獥
qrdb	獦
qrdl	獦
qrd	獦
qfek	獧
qon	獧
qca	獨
qc	獨
qfnc	獨
qzas	獩
qad	獪
qaqd	獪
qae	獫
qaob	獫
qoa	獫
qnds	獬
qrx	獮
qgqf	獯
qnht	獰
qnt	獰
qnsb	獱
qrvu	獲
qu	獲
rqad	獲
qur	獳
qutr	獳
qrd	獵
qsfs	獵
qsl	獵
qsos	獵
qsrq	獵
qs	獵
qtdp	獶
qtmp	獶
qyx	獶
qlk	獷
qlp	獷
qlrb	獷
bqeo	獸
odv	獸
ooqd	獸
qjcb	獺
qvsb	獺
jnbd	獻
nad	獻
zeod	獻
qqns	獼
qqr	獼
qln	獽
qlok	獽
qre	獾
qrov	獾
qtmp	獿
qtzg	獿
qtzp	獿
qztp	獿
qfc	玀
qfsv	玀
qoop	玁
qop	玁
qox	玁
qrok	玂
qmmu	玃
lwa	玄
lws	玅
lwlw	玆
lbwj	率
ljj	率
lwbj	率
lwvk	玈
kaa	玉
kaa	玊
kae	玊
ke	王
kll	玌
pke	玍
vye	玍
kti	玎
kdx	玏
kdy	玏
kie	玒
kna	玓
ksi	玔
kgj	玕
knn	玖
kuj	玗
kfl	玘
kbu	玜
kwj	玝
kqn	玞
kwx	玟
kbr	玠
kxp	玡
kyp	玡
kbd	玢
klp	玣
kfj	玤
kue	玥
kjn	玦
kur	玧
kke	玨
krr	玩
kay	玪
kpx	玫
knae	玬
knl	玬
kbl	玭
kba	环
kap	玲
kat	玲
kpax	玳
ksl	玴
kgo	玵
kpj	玶
kzo	玷
knl	玸
knol	玸
klw	玹
kpx	玻
kzf	玼
kno	玽
kqi	玾
kdo	玿
kpd	珀
kwa	珁
kto	珂
kny	珃
kse	珄
kii	珅
kiqi	珅
kuo	珆
kme	珇
kdo	珈
kox	珉
kmj	珊
knne	珊
knr	珊
kdp	珋
khp	珌
kbm	珍
kns	珎
kvs	珎
kka	珏
kyu	珐
kej	珒
klx	珓
kxiz	珔
kddd	珕
kser	珖
ksr	珗
kza	珘
krb	珙
kod	珚
kxe	珛
kxu	珛
kbh	珜
kee	珝
kpo	珞
krd	珟
ksb	珠
kss	珠
kkb	珡
kdk	珢
knd	珣
kwu	珤
krj	珥
kpno	珦
kra	珧
krbb	珧
kao	珨
kmii	珩
kmit	珩
kyy	珪
ktl	珫
ktr	珫
kaqa	珬
kaqb	珬
kaqe	珬
kaqv	珬
krk	班
kxk	班
kyk	班
kren	珮
krtn	珮
kwm	珳
kix	珴
kok	珵
kbqp	珶
ktp	珶
keaz	珷
kwe	珷
kwo	珸
kaqn	珹
kaqy	珹
kay	珹
keo	珺
kvom	珻
kmb	珼
kkw	珽
kmr	現
koz	珿
kayo	琀
kvfb	琁
kvyz	琁
kio	琂
kajw	球
kna	球
kou	琄
kadk	琅
kan	琅
kqe	理
kq	理
khr	琇
kez	琈
koq	琉
kts	琉
kxb	琊
kyb	琊
kxxn	琋
keay	琌
khr	琍
knez	琔
kpg	琕
kpqg	琕
kaqq	琖
kkx	琖
kjj	琗
kxd	琘
kaqe	琙
khe	琙
kcjo	琚
knbt	琛
knn	琛
knrt	琛
kln	琜
kdw	琝
duka	琞
kve	琟
kfb	琠
krob	琠
kfsu	琡
keqa	琢
klo	琣
kee	琤
kne	琤
kzr	琥
kdto	琦
kvo	琦
oka	琧
kdb	琨
kdd	琩
kkb	琪
kfnq	琫
kncp	琬
kcew	琭
knrs	琮
kns	琮
knb	琯
kff	琰
kno	琱
knyo	琱
krss	琲
ktt	琳
kkay	琴
kyv	琴
kkb	琵
kkcl	琶
kkc	琶
kqj	琸
kzdj	琸
kkt	琹
kwyu	琺
kyu	琺
klos	琼
kls	琼
kho	琽
kyd	琽
kypd	琽
kqbr	琾
knc	琿
kpcu	瑀
kdm	瑁
kcm	瑂
kfnd	瑃
knee	瑄
kne	瑄
kdez	瑅
kjn	瑅
kds	瑆
khom	瑇
kmt	瑈
koxd	瑉
kaqo	瑊
kko	瑊
kwj	瑋
kwos	瑋
krd	瑌
ktnd	瑌
knnd	瑍
knob	瑍
kbpd	瑎
knbx	瑏
knby	瑏
knrx	瑏
knry	瑏
kber	瑐
kbi	瑐
kceq	瑑
kdem	瑒
kdvm	瑒
kep	瑒
kcs	瑓
kjqs	瑓
kpdw	瑔
kofu	瑕
kox	瑕
keru	瑖
kegu	瑗
kex	瑗
krb	瑘
klxu	瑙
kso	瑙
kspo	瑙
kspx	瑙
kswu	瑙
ksx	瑙
kwu	瑙
kfu	瑚
kjou	瑚
krc	瑛
kai	瑜
kaur	瑜
kpdk	瑝
kdi	瑞
ker	瑞
ketr	瑞
kkhp	瑟
kddq	瑠
koq	瑠
kpbn	瑡
kren	瑡
kyen	瑡
knbo	瑢
knw	瑢
ksmb	瑣
kewu	瑤
kuu	瑤
kuwu	瑤
kdf	瑥
kobf	瑥
kwf	瑦
kfnh	瑧
kefd	瑨
keud	瑨
kod	瑨
ffna	瑩
rnka	瑩
kmf	瑪
keg	瑫
wka	瑬
wtsa	瑬
kleo	瑭
kct	瑮
kab	瑯
kadb	瑯
kpqu	瑰
kpru	瑰
kva	瑰
kjb	瑱
kjmb	瑱
kado	瑲
kbp	瑲
kbhi	瑳
kbki	瑳
yneu	瑴
ynku	瑴
kuac	瑵
kubc	瑵
kewu	瑶
kuu	瑶
kuwu	瑶
krat	瑹
krbh	瑹
krbs	瑹
krbt	瑹
ksnn	瑺
koa	瑻
komb	瑻
koxb	瑻
kcua	瑼
kjqa	瑼
kqa	瑼
kxa	瑼
kmiz	瑽
krc	瑾
fvda	瑿
kev	璀
kboh	璁
kpa	璁
kpoh	璁
kkby	璂
kla	璃
klxu	璃
kwuu	璃
kldr	璄
ksqt	璅
keem	璆
kem	璆
kfvz	璇
kzv	璇
khnp	璈
kyfp	璈
kcw	璉
kma	璊
krnb	璊
kldj	璋
kna	璌
klo	璐
kozo	璐
kjd	璒
krhr	璓
kbo	璔
kbqd	璔
keia	璕
kwft	璖
wdea	璗
weka	璗
kmcs	璘
kmc	璘
kmno	璚
keh	璛
kemr	璛
kerm	璛
kka	璜
kreb	璜
kceb	璝
kqa	璝
kfb	璞
kfed	璞
kvn	璞
kdls	璟
kmq	璠
kvw	璡
kefq	璢
kerq	璢
koq	璢
kxq	璢
kyfq	璢
krl	璣
krz	璣
kwb	璣
kwwb	璣
knx	璥
krnp	璥
kenp	璦
khx	璦
cola	璧
pka	璧
kzcm	璨
kzeq	璩
kzn	璩
klt	璪
koot	璪
ksnq	璫
kso	璫
kpdp	璬
kncw	璭
kloe	璮
klom	璮
kad	璯
kaqd	璯
kba	環
kfek	環
kk	環
kon	環
kkkh	璱
kkkx	璱
kbew	璲
ksbb	璳
kssb	璳
kea	璵
keff	璶
kajp	璷
kifp	璷
knsb	璸
kfa	璹
kyya	璹
snka	璺
keej	璻
krf	璼
krvf	璼
nska	璽
rka	璽
kwh	璾
kznm	璿
kur	瓀
kutr	瓀
krvu	瓁
krc	瓂
kryf	瓂
kqqq	瓃
kyfb	瓄
kym	瓄
kpdt	瓅
krn	瓅
kwpt	瓅
ktdp	瓇
ktmp	瓇
kyx	瓇
khdw	瓈
kqab	瓉
kqnb	瓉
klos	瓊
kls	瓊
knfp	瓊
knnp	瓊
knop	瓊
klnw	瓋
kxw	瓋
klfk	瓌
kbxw	瓍
kjcb	瓎
kvsb	瓎
kakp	瓏
kal	瓏
klul	瓏
kzqf	瓐
klhz	瓑
kmcs	瓓
kmjs	瓓
kmn	瓓
kmbg	瓔
ksg	瓔
qrka	瓕
qrk	瓕
kln	瓖
klok	瓖
kevo	瓗
kre	瓘
krov	瓘
kyyf	瓙
ksrb	瓚
knad	瓛
kzed	瓛
ga	瓜
gn	瓜
gna	瓝
gsn	瓞
gnl	瓟
gnol	瓟
drkg	瓠
xga	瓠
ybgg	瓡
yga	瓡
crsg	瓢
lgl	瓣
lga	瓤
lgn	瓤
loog	瓤
gcec	瓥
geqc	瓥
wa	瓦
iwa	瓨
wgj	瓩
bdw	瓫
fwa	瓬
kwa	瓭
nrw	瓭
buw	瓮
foow	瓯
fuw	瓯
fxw	瓯
jow	瓳
apw	瓴
atw	瓴
uow	瓵
bkw	瓶
biw	瓷
riw	瓷
ouw	瓹
xxnw	瓻
snow	瓽
hgw	瓾
low	瓿
gjjw	甀
gwa	甀
bggw	甁
bkw	甁
pgpw	甁
fmw	甂
hfw	甃
cyw	甄
beww	甆
rwww	甆
ffnw	甇
pmtw	甈
beew	甉
qwa	甉
mgw	甊
lnjw	甋
xwa	甋
foow	甌
fxw	甌
rfnw	甍
cuaw	甎
jquw	甎
xwa	甎
ydmw	甏
yobw	甏
mcsw	甐
mcw	甐
bqdw	甑
bwa	甑
ekw	甒
glw	甒
vffw	甒
colw	甓
pwa	甓
nlbw	甔
nlrw	甔
vwa	甔
lwvw	甕
mbmw	甖
swa	甖
zeow	甗
go	甘
kbl	甚
klb	甚
klr	甚
kl	甚
krl	甚
ggo	甛
gog	甜
zrg	甝
snog	甞
se	生
sse	甡
lpp	產
lps	產
wls	產
lls	産
lps	産
wls	産
eqs	甤
sqd	甥
tqxs	甦
tse	甦
nqj	用
nql	甩
pnq	甪
ajnq	甫
ij	甫
tj	甬
tnq	甬
bnq	甭
nmnq	甮
nhnq	甯
qo	田
iqo	由
qii	甲
qi	甲
ii	申
iqi	申
qdx	男
qdy	男
nqo	甸
iqk	甹
qti	町
equ	画
qsi	甽
sqo	甾
qfl	甿
qer	畀
iqer	畁
qer	畁
qnn	畂
sqo	畄
lqu	畆
qnb	畇
qnr	畇
qlu	畈
qqn	畉
qjj	畊
qpx	畋
qbr	界
qr	界
qbr	畍
qad	畎
qkn	畏
ioq	畐
qbj	畔
qqo	畕
qga	畖
qgn	畖
loq	畗
lqo	畗
qny	畘
ddq	留
oqo	留
udq	畚
qbm	畛
lwq	畜
lqnn	畝
lqo	畝
jqnn	畞
qbp	畟
qrp	畟
qlh	畡
bjj	畢
qjjq	畢
qj	畢
qrj	畢
aoq	畣
beoq	畣
qya	畤
qpo	略
qyy	畦
qpo	畧
mqo	畨
mqo	番
eqe	畫
equ	畫
tqu	畫
bhq	畬
qat	畭
qbh	畭
qvom	畮
qhx	畯
qubp	畯
qurp	畯
olr	異
qrb	異
effq	畱
erfq	畱
oqo	畱
xqo	畱
yffq	畱
nee	當
see	當
snoq	當
so	當
quuu	畷
qdto	畸
qvo	畸
qncp	畹
eqee	畺
qgq	畽
qqq	畾
wqo	畿
wwaq	畿
sqjz	疀
sqzz	疀
qeem	疁
qem	疁
qlq	疃
qmcs	疄
qmc	疄
qyee	疆
qfa	疇
qyya	疇
qqqe	疉
qqqf	疉
qmv	疊
qnm	疊
qqqm	疊
uuum	疊
yzn	疋
jez	疌
jzn	疌
zez	疌
yzjs	疎
yzvs	疎
ysv	疏
yzts	疏
jnqz	疐
fvdz	疑
fz	疑
lba	疒
lbe	疒
lbr	疓
lbt	疔
lbf	疕
lbi	疘
lbvz	疙
lbnn	疚
lba	疛
lbe	疝
lbrk	疞
lbf	疢
lbak	疣
lbcl	疤
lbc	疤
lbbr	疥
lbj	疦
lbx	疧
lbx	疨
lby	疨
lbb	疪
lbru	疫
lbak	疰
lbnl	疱
lbn	疱
lbp	疲
lbg	疳
lbto	疴
lbzf	疵
lbs	疶
lbde	疸
lbbm	疹
lbbz	疺
lbpz	疺
lbob	疻
lbpb	疼
lbm	疽
lbvd	疾
lg	疾
lbv	疿
lbno	痀
lbzo	痁
lbdo	痂
lblw	痃
lbvf	痄
lbeb	病
lbe	病
lbtb	病
lb	病
lbez	症
lzv	症
lbbk	痊
lbc	痋
lbno	痌
lbe	痍
lbjb	痍
lblh	痎
lbxu	痏
lbx	痏
lboo	痐
lbcc	痑
lbbh	痒
lbp	痓
lbya	痔
lbdk	痕
lbvm	痗
lbd	痘
lbei	痙
lbsi	痙
lbui	痙
lbuy	痙
lbyz	痚
lbtq	痛
lbt	痛
lq	痛
lbam	痝
lba	痝
lbbo	痞
lbsu	痟
lbh	痠
lbup	痠
lbaq	痡
lbi	痡
lbhr	痢
lbyh	痣
lbby	痤
lbbr	痥
lbwo	痦
lbws	痧
lbuu	痭
lbek	痮
lbnb	痯
lbff	痰
lbrs	痱
lbtt	痲
lbtt	痳
lbvo	痴
lbhz	痵
lbfb	痶
lbrb	痶
lbdl	痷
lbsr	痸
lbqr	痹
lbpg	痺
lbxd	痻
lboo	痼
lbv	痽
lbbo	痾
lbhg	痿
lbfb	瘀
lbjj	瘁
lbo	瘂
lbea	瘃
lbeq	瘃
lbgq	瘇
lbfd	瘈
lbhd	瘈
lbar	瘉
lba	瘉
lbpd	瘊
lbrc	瘋
lbrx	瘋
lbjr	瘌
lbvr	瘌
lbdm	瘍
lbe	瘍
lbkb	瘎
lbkl	瘎
lbkr	瘎
lbk	瘎
lbh	瘏
lbyd	瘏
lbgb	瘐
lbqo	瘑
lbnd	瘓
lbro	瘔
lbou	瘕
lbo	瘕
lbld	瘖
lbuc	瘙
lbbi	瘚
lbfh	瘛
lbhh	瘛
lbph	瘜
lbfw	瘝
lbgy	瘞
lbdf	瘟
lbof	瘟
lbbu	瘠
lbfu	瘠
lbru	瘠
lbwu	瘠
lbao	瘡
lbbp	瘡
lbzu	瘢
lbpu	瘣
lbv	瘣
lbdq	瘤
lboq	瘤
lbbi	瘥
lbgu	瘦
lbe	瘧
lbze	瘧
lbjb	瘨
lbro	瘩
lbqk	瘬
lbcs	瘭
lbfd	瘯
lbqs	瘰
lbgh	瘱
lbmz	瘲
lbem	瘳
lblj	瘴
lbjs	瘵
lbj	瘵
lbji	瘶
lbvi	瘶
lbjp	瘷
lbvp	瘷
lbdb	瘸
lbcu	瘺
lbmg	瘻
lbrd	瘼
ldv	瘼
lbrc	瘽
lbds	療
lbl	療
lbw	療
lbbs	癃
lbvf	癄
lbeq	癅
lboq	癅
lbxq	癅
lbyq	癅
lbfd	癆
lbrd	癆
lbmu	癇
lbf	癈
lbju	癈
lboj	癉
lbo	癉
lboe	癌
lbfk	癏
lbo	癏
lbad	癐
lbfk	癑
lbrk	癑
lbah	癒
lbmp	癓
lbcg	癖
lbcl	癖
lbp	癖
lbuq	癗
lbru	癘
lbgs	癙
lbni	癚
lbv	癚
lblh	癛
lbls	癛
lbcu	癜
lbpf	癟
lbpm	癟
lbwh	癠
lbfz	癡
lbbx	癢
lbzp	癤
lbmp	癥
lbhz	癧
lblz	癧
lbuv	癨
lbjb	癩
lbvb	癩
lbhb	癪
lbuh	癬
lbmg	癭
lbsg	癭
lbbh	癮
lbmv	癯
lbsv	癰
lbrv	癱
lbuv	癱
lbjb	癲
lbjt	癲
lbib	癵
lbsb	癵
jn	癶
jp	癶
jed	癸
jgn	癸
knv	癸
kn	癸
jru	癹
jde	登
axu	發
fx	發
jkj	發
jkl	發
jqru	發
pdo	白
tdo	百
pdl	癿
pdc	皀
pdf	皀
pdj	皁
pdc	皂
pdf	皂
pdr	皃
d	的
pdna	的
bpd	皆
pdk	皇
pdlu	皈
pdzf	皉
pdap	皊
pdat	皊
pddj	皋
pdfj	皋
pdjf	皋
pdte	皋
pdwj	皋
pdlx	皎
pdbk	皏
adrj	皐
adwj	皐
pdrj	皐
pdwj	皐
pdi	皒
pdso	皓
pddg	皔
tdtd	皕
pdnr	皖
pdno	皗
pdn	皗
pdhl	皘
pdhu	皘
tkd	皙
tkpd	皙
pded	皚
pdpd	皛
pdlo	皜
pdq	皜
pdkr	皝
pdpj	皞
pdpj	皡
pda	皣
pdrq	皣
pdmq	皤
pdpj	皥
pdpp	皦
pdkr	皩
pdpt	皪
pdr	皪
pdwt	皪
pdlf	皫
pdea	皭
px	皮
pgj	皯
pnl	皰
pnol	皰
ajwp	皳
npx	皳
hpx	皴
ubpp	皴
urpp	皴
rdp	皵
ydp	皷
ncp	皸
pnc	皹
nenp	皺
nep	皺
zmp	皻
loop	皽
jmp	皾
yfmp	皾
ymp	皾
fev	皿
fe	皿
pfe	盀
rfe	盁
ufe	盂
bfe	盃
qif	盄
cfe	盅
bdf	盆
daf	盇
ruf	盈
wpf	盈
hfe	盉
bebf	益
y	益
afe	盋
axuf	盋
axxf	盋
cpf	盌
ce	盍
yuf	盍
cfe	盎
aof	盒
wuf	盓
lff	盔
xff	盔
wraf	盕
bkf	盖
ce	盖
bif	盗
ajnf	盙
ife	盙
ajwf	盚
nfe	盚
afe	盛
aqnf	盛
aqpf	盛
bif	盜
rif	盜
wif	盜
cewf	盝
aqaf	盞
kfe	盞
duf	盟
cnb	盡
eff	盡
qadf	盢
rfe	監
rvaf	監
rvef	監
zfe	盤
zf	盤
zruf	盤
ewef	盥
gwf	盥
wgf	盥
ayef	盦
zcp	盧
zqf	盧
jpf	盩
ybgf	盩
ypf	盩
wdef	盪
wdvf	盪
wef	盪
aoef	盫
rjof	盬
rvjf	盬
rvzf	盬
rwof	盬
wybf	盭
wypf	盭
mo	目
mti	盯
mgj	盰
muj	盱
fmo	盲
mfl	盳
je	直
jme	直
jml	直
mvz	盵
mnb	盷
mnr	盷
tmo	相
tm	相
mel	盹
mki	盺
mak	盻
mbk	盻
mbd	盼
md	盼
mfj	盽
kmo	盾
xmo	盾
mwx	盿
smo	省
sm	省
mta	眃
mfk	眄
mtly	眄
mlu	眅
msp	眇
mkl	眈
mnr	眈
cmo	眉
mml	眊
hmo	看
mrs	眎
mcn	眏
mez	眐
mwd	眑
mii	眒
miqi	眒
maqi	眓
mbm	眕
mor	眖
dbm	眘
muo	眙
smo	眚
mqb	眛
mys	眛
mnt	眝
fmlb	眞
jba	眞
jmlb	眞
fmlb	真
jba	真
jmeb	真
jmlb	真
mox	眠
mxe	眡
cpm	眢
msn	眣
mcf	眤
zfm	眥
mzf	眦
mdo	眧
mbz	眨
mpaz	眨
mpz	眨
mlw	眩
menb	眪
men	眪
mtnb	眪
mbj	眫
myy	眭
mmn	眯
mpe	眰
men	眱
mjqb	眱
mrj	眲
mco	眳
mnd	眴
mcc	眵
mfk	眶
bnm	眷
mus	眸
mbed	眹
mbgn	眹
mgn	眹
mra	眺
mrbb	眺
mbh	眻
mdk	眼
mlk	眽
bbb	眾
fmk	眾
fnbb	眾
fpbb	眾
fqn	眾
pfmk	眾
pfpb	眾
pfq	眾
mun	眿
bhm	着
bkpm	着
rd	着
bbim	睂
bblm	睂
mhx	睃
mubp	睃
murp	睃
msu	睄
mdg	睅
mnrr	睆
mbqp	睇
mtp	睇
mok	睈
mbby	睉
mou	睊
mix	睋
mdcr	睌
mel	睌
mncr	睌
mmr	睍
mxxn	睎
mot	睏
mff	睒
mfb	睓
mrob	睓
mam	睔
mncp	睕
mybp	睖
myrp	睖
myx	睖
feok	睘
on	睘
mfad	睙
mlyy	睚
mhu	睛
mu	睛
mee	睜
mne	睜
hdm	睝
mln	睞
mjj	睟
mbnl	睠
mbnp	睠
mpl	睠
mge	睡
mgjy	睡
mve	睢
fm	督
fsum	督
miqr	睤
mqer	睤
mpg	睥
mpqg	睥
mqu	睦
myby	睦
mye	睦
myry	睦
mxd	睧
mgr	睨
mcew	睩
fybg	睪
fyj	睪
mjez	睫
mjz	睫
mzez	睫
met	睬
mmn	睬
mno	睭
mnyo	睭
mai	睮
maur	睮
oxpm	睯
mofu	睱
mox	睱
mnc	睴
mjao	睵
mfnd	睶
mew	睷
mcm	睸
hmr	睹
mho	睹
mypd	睹
ypdr	睹
mpfd	睺
mnee	睻
mne	睻
mdez	睼
mjn	睼
mjed	睽
mjgn	睽
mkn	睽
pfyg	睾
pfy	睾
znbm	睿
znem	睿
mpm	瞀
mmad	瞁
kmax	瞂
kma	瞂
xmax	瞂
xma	瞂
mkm	瞃
mxm	瞃
mrq	瞄
mhf	瞅
mmw	瞇
mbue	瞈
yneu	瞉
ynmu	瞉
mleo	瞊
mjb	瞋
mjmb	瞋
mce	瞌
myuf	瞌
mgiu	瞍
mgu	瞍
mnfo	瞎
mnho	瞎
fyok	瞏
mmm	瞐
mndl	瞑
mldj	瞕
fvdm	瞖
mnf	瞗
mfoo	瞘
mfx	瞘
mrdd	瞙
mna	瞚
mneb	瞚
mmiz	瞛
mmg	瞜
mla	瞝
mlxu	瞝
mwuu	瞝
mrnb	瞞
mcrs	瞟
msny	瞠
mqar	瞡
mql	瞡
mqnr	瞡
rfnm	瞢
mcch	瞣
mmk	瞤
bmo	瞥
snsm	瞥
mydo	瞦
myoo	瞦
mvf	瞧
mfb	瞨
mfed	瞨
mvn	瞨
mcpu	瞩
mjd	瞪
mcdj	瞫
mxj	瞫
menc	瞬
mens	瞬
msv	瞬
mdbs	瞭
mla	瞭
mmu	瞯
mirp	瞰
mtrp	瞰
maj	瞱
mrjq	瞱
mrrj	瞱
mrrq	瞱
mmno	瞲
mlq	瞳
mek	瞴
mgl	瞴
mvff	瞴
mmcs	瞵
mmc	瞵
mceb	瞶
mqa	瞶
mmd	瞷
mrst	瞸
menp	瞹
mhx	瞹
mad	瞺
maqd	瞺
mnli	瞻
mvo	瞻
mac	瞼
mae	瞼
maob	瞼
moa	瞼
ydjm	瞽
yobm	瞽
mmni	瞾
mmv	瞿
mmip	矀
mhfh	矁
mlt	矂
moot	矂
mgqf	矄
meev	矅
mrvu	矆
mrnq	矇
mnsb	矉
mspn	矊
msp	矊
mlk	矌
mlrb	矌
mmvu	矍
mnfp	矎
mnnp	矎
mpmf	矏
muv	矐
mzqf	矑
makp	矓
mal	矓
mlul	矓
mre	矔
mrov	矔
issm	矕
lfm	矕
sism	矕
jjj	矗
jmee	矗
jmll	矗
msnf	矘
mmip	矙
mmtp	矙
mcwc	矚
mc	矚
mxa	矚
mp	矛
may	矜
map	矝
mat	矝
mnbo	矞
mnro	矞
msu	矟
mrd	矠
vdn	矢
an	矣
uvd	矣
vdo	知
nlvd	矦
nvd	矦
vdqi	矧
vdgn	矨
vdpd	矨
vdff	矩
vfv	矩
vdby	矬
vdd	短
vdhg	矮
vg	矮
vdeo	矯
vdgo	矯
vdgr	矯
vdg	矯
vdpo	矯
vdbd	矰
vdb	矰
vdru	矱
vdff	矲
vdfu	矲
loo	石
lot	矴
lor	矵
loz	矷
log	矸
loer	矹
log	矺
lovz	矻
loi	矼
loc	矽
los	砂
lsv	砂
lone	砃
lonl	砃
loj	砄
low	砅
loqn	砆
low	砇
lolp	砈
flo	砉
hlo	砉
lolr	砊
loz	砋
locd	砌
loi	砍
lobr	砎
lobd	砏
lopu	砐
lorn	砐
lox	砑
loy	砑
lobr	砒
lob	砒
loru	砓
lok	研
lokj	砕
loyu	砝
lovf	砟
lom	砠
loka	砡
loto	砢
lonf	砣
lova	砤
loxe	砥
zflo	砦
lozo	砧
lofz	砨
lov	砩
loom	砪
loak	砫
lol	砬
lobz	砭
lopz	砭
gulo	砮
loaw	砯
lop	砰
loap	砱
loat	砱
lonl	砲
lon	砲
lolo	砳
lop	破
lote	砵
lopd	砶
loii	砷
loi	砷
lofn	砸
lobk	硂
losb	硃
loss	硃
loyy	硅
loao	硆
lopo	硇
lopx	硇
loyo	硈
loe	硉
lonp	硊
lolh	硋
lopo	硌
lodk	硍
lokr	硎
logg	硏
lok	硏
lono	硐
lobg	硑
lobk	硑
lopg	硑
loc	硒
loei	硜
losi	硜
loui	硜
louy	硜
losu	硝
loso	硞
lopw	硟
loak	硠
loa	硠
lobh	硢
loyz	硣
log	硤
loam	硥
lokr	硦
loc	硨
jklo	硩
loi	硪
lots	硫
lotx	硬
lot	硬
lorf	硭
lon	确
lomr	硯
wslo	硰
loot	硱
loeg	硸
lotu	硹
loea	硺
loeq	硺
rulo	硻
louu	硼
lodl	硽
lox	硽
logy	硾
log	硾
loni	硿
loee	碀
lone	碀
kblo	碁
lons	碂
lohu	碃
lott	碄
looh	碅
wplo	碆
lonz	碇
loxd	碈
lono	碉
lon	碉
lov	碉
loaq	碊
lok	碊
loeo	碋
locw	碌
loew	碌
loda	碍
lojj	碎
lord	碏
loyp	碐
loy	碐
lopg	碑
loa	碒
lov	碓
loez	碔
low	碔
lodo	碕
lov	碕
loam	碖
lonp	碗
lofb	碘
lorb	碘
lone	碙
lolo	碚
oooo	碞
lost	碟
lt	碟
lolt	碠
lohm	碡
loqo	碢
lodl	碣
lod	碣
lorc	碤
lofm	碥
lono	碦
kov	碧
kpdo	碧
loqk	碨
lotb	碩
lot	碩
lokb	碪
lokl	碪
lokr	碪
lok	碪
loeu	碫
loou	碬
loo	碬
lodm	碭
loe	碭
lodz	碮
loj	碮
loso	碯
losx	碯
los	碯
lev	碰
lobe	碰
lobo	碰
lob	碰
loao	碱
lok	碱
loln	碲
loef	碳
lote	碴
lotm	碴
lonv	確
lon	確
lv	確
lolo	碻
loq	碻
lomf	碼
tf	碼
lock	碾
lobw	磀
lc	磁
lobw	磁
lolw	磁
lorw	磁
lodq	磂
looq	磂
lolr	磃
lolo	磄
log	磅
lolf	磅
loqu	磆
lopb	磇
lopu	磈
lov	磈
lout	磉
lolo	磊
lobi	磋
lojb	磌
lono	磍
loed	磎
lobf	磏
loq	磏
zruo	磐
loed	磑
loob	磒
lopw	磓
loct	磔
loc	磕
loyf	磕
loed	磖
loca	磚
loja	磚
loqa	磚
lox	磚
cklo	磛
lojs	磜
loj	磜
lohp	磝
loyp	磝
loeu	磞
loem	磟
lozf	磠
lozo	磠
lozx	磠
lokd	磡
lodx	磢
lojb	磢
loum	磣
loqs	磥
lohb	磧
ltto	磨
loas	磩
loev	磪
lomz	磫
ycro	磬
ylo	磬
lofu	磭
lor	磯
lowb	磯
lobo	磰
lofd	磱
lord	磱
lowt	磲
lobd	磳
lob	磳
lojd	磴
lomc	磷
loms	磷
lobd	磸
locj	磹
lox	磹
lok	磺
lorb	磺
lomq	磻
lovt	磼
loyr	磽
looj	磾
loo	磾
lhho	磿
lovf	礁
loyo	礂
logo	礄
log	礄
lopo	礄
lolp	礅
loab	礆
loo	礆
lopd	礇
lobw	礈
lopp	礉
cruo	礊
curo	礊
lofg	礋
lofy	礋
louq	礌
lord	礍
lorl	礍
loee	礎
loeu	礎
lotz	礎
lz	礎
snlo	礐
losq	礑
los	礑
lobi	礒
lob	礒
loee	礓
locl	礔
lop	礔
colo	礕
plo	礕
lonb	礗
lodf	礘
loda	礙
lofz	礙
vz	礙
lorc	礚
lorf	礚
lorf	礛
elo	礜
lour	礝
lorq	礞
lobh	礠
lorh	礠
lora	礡
lorx	礡
lora	礣
lorb	礣
lore	礣
lorv	礣
lorj	礤
lors	礤
lorb	礥
lolb	礦
lolk	礦
lol	礦
loqq	礧
qqqo	礨
lokb	礩
lolu	礪
lolv	礪
lofs	礫
lopt	礫
lor	礫
lowt	礫
lora	礬
txxo	礬
louv	礭
lomx	礮
lofs	礯
lolz	礰
alo	礱
lulo	礱
loa	礲
loll	礲
loum	礵
lorf	礷
losb	礸
loop	礹
loo	礹
rsa	示
rsl	礼
rsr	礽
rsy	社
rsna	礿
rsol	祀
rsb	祁
rsa	祂
rsbr	祄
rsgn	祅
rspd	祅
rsed	祆
rsgn	祆
rsx	祇
rsk	祈
rsz	祉
rsf	祊
rsru	祋
rsc	祌
rslo	祏
rsxo	祐
rssn	祑
rsdo	祒
rsax	祓
rsa	祓
rspa	祔
rshp	祕
rsm	祖
rsxe	祗
rsrs	祘
rsqb	祙
rsys	祙
rsvf	祚
rsyu	祛
rsjo	祜
rsor	祝
rsii	神
rsi	神
eers	祟
eurs	祟
rse	祠
rsyo	祠
zfrs	祡
rsns	祢
rsvs	祢
rsvk	祣
rsee	祤
rhv	祥
rsbh	祥
rsrb	祧
rsr	祧
crs	票
rssb	祩
rsss	祩
rsnp	祪
rsao	祫
rsp	祬
ja	祭
jrs	祭
rsyo	祮
rsso	祰
rsbr	祱
rseu	祲
rsr	祲
rsfk	祳
rsar	祴
rsot	祵
rsbp	祶
rst	祶
rsne	祹
rsnu	祹
rsn	祹
rskb	祺
rsqt	祼
rsjj	祽
rsyp	祾
rsy	祾
rscw	祿
rsew	祿
looh	禀
loos	禀
ts	禁
ttrs	禁
tw	禁
rsno	禂
rsn	禂
rsje	禃
rsjm	禃
rsj	禃
rscw	禄
rsew	禄
rsh	禇
rsyd	禇
rsnc	禈
rsbe	禉
rsfd	禊
rshd	禊
rscy	禋
ct	禍
rsob	禍
rsqo	禍
rszb	禎
rq	福
rseq	福
rsep	禐
rseu	禐
rse	禐
rscq	禒
rsdm	禓
rse	禓
rsdz	禔
rsj	禔
rsws	禕
rsw	禕
rsgt	禖
rsqh	禗
rsln	禘
rsbf	禚
rsjb	禛
ffns	禜
rsqp	禝
rslo	禞
rsq	禞
rslo	禟
rslr	禠
rsmf	禡
rsde	禢
rsfe	禤
rsky	禥
mivs	禦
miws	禦
rsyo	禧
rswb	禨
rsqb	禩
rsoj	禪
rso	禪
rscj	禫
rsx	禫
rsad	禬
rsbw	禭
rsfd	禮
rsl	禮
rsrd	禮
rsfk	禯
rsrk	禯
rsr	禰
rsfa	禱
rsya	禱
rslu	禲
rsf	禳
rslk	禳
rsl	禳
rsam	禴
rsdb	禵
rsdt	禵
rsjb	禵
rsjt	禵
rssb	禶
rsat	禷
rsmb	禷
nua	禸
pcnu	禹
qnu	禺
la	离
lxuu	离
wunu	离
bla	禽
blxu	禽
bwuu	禽
hn	禾
hrl	禿
hrz	禿
hrp	秀
hua	私
hrl	秃
hrz	秃
hzj	秄
hgl	秅
hgj	秆
hka	秇
hza	秇
hzx	秇
hei	秈
ges	秉
hgj	秊
hfn	秋
hci	种
hcj	种
hbd	秎
hml	秏
hta	秐
hdj	科
hsp	秒
hju	秓
hlr	秔
hbl	秕
hxx	秖
hgn	秗
hpd	秗
hhp	秘
hjo	秙
hbj	秚
hpx	秛
hcf	秜
hhn	秝
hiq	秞
hme	租
hbe	秠
haxu	秡
haxx	秡
hax	秡
hap	秢
hat	秢
hqb	秣
hys	秣
hpj	秤
hzo	秥
fnh	秦
hcn	秧
hcv	秧
hvf	秨
hsn	秩
hxe	秪
hat	秫
hff	秬
hjp	秭
huo	秮
hns	称
hvs	称
hneo	秱
hya	秲
hgo	秳
hod	秵
bih	秶
rih	秶
hpe	秷
hyo	秸
hpk	秹
hng	秺
hcc	移
hajq	秿
hij	秿
hxxn	稀
hadk	稂
han	稂
hez	稃
hhx	稄
hubp	稄
hurp	稄
hbor	稅
hr	稅
hot	稇
hdg	稈
htqx	稉
htx	稉
hbqp	稊
htp	稊
hc	程
hok	程
hbh	稌
hsu	稍
hbor	税
hr	税
hoe	稏
ham	稐
hqu	稑
hyby	稑
hye	稑
hyry	稑
hojo	稒
hrd	稓
hayh	稔
hlhz	稕
hloz	稕
hlz	稕
hpg	稗
hpqg	稗
hkb	稘
hje	稙
hjl	稙
hjme	稙
hjml	稙
hve	稚
hoh	稛
hybp	稜
hyrp	稜
hyx	稜
huu	稝
hqt	稞
looh	稟
loos	稟
hno	稠
hnyo	稠
haqe	稢
hhe	稢
hwj	稦
hwos	稦
hfm	稨
hqu	稩
hvdp	稪
hvx	稪
heoq	稫
hrd	稬
htnd	稬
hbpd	稭
hci	種
hcj	種
hgq	種
hxup	稯
hfbu	稰
hyzu	稰
heny	稱
hns	稱
hvs	稱
hy	稱
heid	稲
hqbp	稷
hqrp	稷
hlwq	稸
hjb	稹
hjmb	稹
hcl	稺
heg	稻
heid	稻
hneq	稼
hakd	稽
lhnh	稾
lnoh	稾
lonh	稾
qhn	稾
hlho	稿
hlno	稿
hloo	稿
hqo	稿
yneu	穀
ynhu	穀
hrr	穁
hch	穂
hjqh	穂
hja	穄
hjrs	穄
hlew	穅
hpdm	穆
hudm	穇
hum	穇
huum	穇
ltth	穈
hcws	穉
hdl	穊
hduk	穊
heem	穋
hem	穋
ufh	穌
hb	積
hhmb	積
hob	積
fhtb	穎
fht	穎
frsb	穎
frst	穎
heeh	穏
hh	穏
hqrb	穓
hka	穔
hreb	穔
hwb	穖
hwwb	穖
hch	穗
hcuh	穗
hjqh	穗
hyr	穘
hyyr	穘
hgi	穚
hgno	穚
hgo	穚
hpdo	穚
hvf	穛
hlq	穜
hbew	穟
hffk	穠
hnk	穠
hrok	穠
httk	穠
hwoo	穡
hec	穢
hzas	穢
hur	穤
hutr	穤
hnsb	穦
hwh	穧
hrcb	穨
hrq	穨
heeh	穩
heih	穩
hh	穩
hneh	穩
hrx	穪
hrvu	穫
hlk	穬
hlrb	穬
hufd	穭
hlbf	穮
hjoo	穯
hwoo	穯
hln	穰
hlok	穰
hefa	穱
hla	穲
hllb	穲
hsrb	穳
nba	穴
nbn	穴
nbz	穵
nrz	穵
nbk	究
nk	究
nrk	究
nbc	穸
nrc	穸
nbq	穹
nrq	穹
nbi	空
nri	空
nbu	穻
nru	穻
nbt	穼
nrt	穼
nbj	穽
nrj	穽
nbed	穾
nbgn	穾
nbpd	穾
nred	穾
nrgn	穾
nrpd	穾
nbx	穿
nby	穿
nrx	穿
nry	穿
nbe	窀
nre	窀
nbad	突
nd	突
nrad	突
nbs	窂
nrs	窂
nbcd	窃
nrcd	窃
nbvf	窄
nrvf	窄
nbm	窅
nrm	窅
nbbz	窆
nbpz	窆
nrbz	窆
nrpz	窆
nbnl	窇
nbn	窇
nrnl	窇
nrn	窇
nbwd	窈
nrwd	窈
nbeb	窉
nbe	窉
nreb	窉
nre	窉
nbg	窊
nrg	窊
nbee	窋
nbeu	窋
nree	窋
nreu	窋
nbdp	窌
nrdp	窌
nbwu	窏
nrwu	窏
nbyy	窐
nryy	窐
nbwu	窑
nrwu	窑
nbp	窒
nrp	窒
nbuh	窓
nruh	窓
nblx	窔
nrlx	窔
nbrb	窕
nbr	窕
nrrb	窕
nrr	窕
nbso	窖
nrso	窖
nbpc	窗
nbpo	窗
nbpq	窗
nbuh	窗
nrpc	窗
nrpo	窗
nrpq	窗
nruh	窗
nbeo	窘
nreo	窘
nbyz	窙
nryz	窙
nban	窚
nbay	窚
nba	窚
nran	窚
nray	窚
nra	窚
nbdg	窞
nbng	窞
nrdg	窞
nrng	窞
nbce	窟
nbcu	窟
nrce	窟
nrcu	窟
nbqt	窠
nrqt	窠
nbuu	窡
nruu	窡
nbae	窢
nbh	窢
nrae	窢
nrh	窢
nbjj	窣
nrjj	窣
nbdb	窤
nrdb	窤
nbld	窨
nrld	窨
nbob	窩
nbqo	窩
nrob	窩
nrqo	窩
nbwy	窪
nrwy	窪
nbfd	窫
nbhd	窫
nrfd	窫
nrhd	窫
nbar	窬
nba	窬
nrar	窬
nra	窬
nbd	窮
nbsq	窮
nqv	窮
nrd	窮
nrsq	窮
nbbf	窯
nbue	窯
nbuu	窯
nbwu	窯
nrbf	窯
nrue	窯
nruu	窯
nrwu	窯
nbee	窰
nbue	窰
nbuu	窰
nree	窰
nrue	窰
nruu	窰
nbpt	窱
nbp	窱
nrpt	窱
nrp	窱
nbmd	窲
nrmd	窲
nbgg	窳
nrgg	窳
nbjb	窴
nrjb	窴
nbnf	窵
nrnf	窵
nbmg	窶
nrmg	窶
nbrp	窷
nrrp	窷
nbeh	窸
nbmh	窸
nreh	窸
nrmh	窸
nbqr	窺
nbq	窺
nrqr	窺
nrq	窺
nbph	窻
nbp	窻
nrph	窻
nrp	窻
nbfi	窽
nrfi	窽
nbyi	窾
nryi	窾
nbbs	窿
nrbs	窿
nber	竀
nrer	竀
nbmm	竁
nrmm	竁
nbds	竂
nbl	竂
nrds	竂
nrl	竂
nbcc	竄
nbgs	竄
nrcc	竄
nrgs	竄
nbik	竅
nbpp	竅
npv	竅
np	竅
nrik	竅
nrpp	竅
nbjd	竇
nbyb	竇
nbym	竇
nryb	竇
nrym	竇
nbyx	竈
nryx	竈
nba	竉
nbll	竉
nra	竉
nrll	竉
nbcd	竊
nbeu	竊
nbmu	竊
nrcd	竊
nreu	竊
nrmu	竊
nu	竊
le	立
lrl	竌
lrz	竌
lru	竐
lxu	竑
lio	竒
loi	竒
lto	竒
lno	竘
lzo	站
lnt	竚
lap	竛
lat	竛
liql	竜
lql	竜
lle	竝
ldr	竟
ldj	章
lan	竢
luvd	竢
lhx	竣
lubp	竣
lurp	竣
lnxu	竤
lqe	童
ljcs	竦
lvs	竦
lsx	竧
lnm	竩
rul	竪
lee	竫
lne	竫
lpcu	竬
ldl	竭
ldnl	竭
lcbk	竮
ldi	端
ler	端
letr	端
lcua	竱
ljqa	竱
lxa	竱
lbo	竲
lbqd	竲
ljd	竳
leot	竵
ltot	竵
lorr	競
lor	競
lr	競
ldjp	竷
ldrr	竸
zi	竹
zre	竺
zdx	竻
zdy	竻
zra	竼
zuj	竽
zal	竾
zgj	竿
zfl	笀
zie	笁
zkj	笄
zxx	笅
zcl	笆
zpu	笈
zrn	笈
znb	笉
znr	笉
zei	笊
zen	笊
zex	笋
znb	笍
zrr	笎
znm	笏
zlr	笐
zed	笑
zgn	笑
zpd	笑
zay	笒
zbl	笓
zml	笔
zua	笖
zub	笖
zpb	笗
zzo	笘
zse	笙
zqi	笚
ziq	笛
zee	笜
zeu	笜
zou	笝
zuo	笞
zga	笟
zgn	笟
zle	笠
zme	笡
zox	笢
znl	笣
znol	笣
zdo	笤
zeo	笥
zyeo	笥
zpa	符
zte	笨
zde	笪
zjp	笫
zp	第
zqip	第
zqp	第
ztp	第
zap	笭
zat	笭
zvf	笮
zgu	笯
zvj	笰
zno	笱
zur	笲
zdo	笳
zto	笴
zwp	笵
zvd	笶
zfo	笸
zfp	笻
zip	笻
zyy	筀
zfo	筁
zror	筁
zwa	筂
zod	筃
zra	筄
zrbb	筄
zsr	筅
zej	筆
zml	筆
zib	筇
zgo	筈
zya	等
zlx	筊
zud	筋
zbk	筌
zex	筍
znd	筍
zgo	筎
zpaq	筏
zfk	筐
zira	筑
ziz	筑
zneo	筒
zgg	筓
zkj	筓
zao	答
zmii	筕
zmit	筕
zjns	策
zjn	策
zpc	筗
zjo	筘
znt	筞
zynb	筠
zynr	筠
zat	筡
zbh	筡
zjcl	筢
zjc	筢
zhr	筣
zadk	筤
zan	筤
zopo	筥
znrr	筦
zmr	筧
zayo	筨
ztj	筩
ztnq	筩
zmb	筫
zaqn	筬
zaqy	筬
zay	筬
zkr	筭
zwe	筮
zmd	筯
zpvf	筰
zpip	筱
zsu	筲
zkw	筳
zgn	筴
zpzw	筵
zso	筶
zhj	筷
zdg	筸
zfa	筹
zlo	箁
zln	箂
zru	箃
zpg	箄
zpqg	箄
zqer	箅
znbb	箆
zojo	箇
zwuo	箈
zfbb	箊
zaf	箋
zaqq	箋
zkx	箋
zpr	箌
zjfn	箍
zzr	箎
zeev	箏
zee	箏
zne	箏
zhu	箐
zjez	箑
zjz	箑
zzez	箑
zej	箒
zenn	箒
zcew	箓
zew	箓
zwpd	箔
zkb	箕
ztt	箖
zmr	算
zoh	箘
zupu	箙
zzg	箛
znbi	箜
znri	箜
zjg	箝
zbnp	箞
zpl	箞
zdb	箟
zge	箠
zgjy	箠
enb	管
znb	管
zjnr	箣
zjr	箣
zjj	箤
zro	箬
zrxo	箬
zber	箭
zbi	箭
znee	箮
zne	箮
zptx	箯
zpt	箯
ztm	箱
zwsr	箲
zcbg	箳
zcbk	箳
zcjg	箳
zcjq	箳
zcpg	箳
zcpk	箳
zaqo	箴
zko	箴
zsm	箵
zfva	箷
zho	箸
zypd	箸
zsna	箹
zsur	箾
zor	箿
rpi	節
zadp	節
zap	節
zdup	節
zgi	節
zpi	節
zpdk	篁
zcp	範
zceq	篆
zeq	篆
zfm	篇
zirt	築
zizt	築
zt	築
zwrb	篊
zfg	篋
zpfd	篌
zhf	篍
zms	篎
zomb	篔
zce	篕
zyuf	篕
znee	篘
zlho	篙
zlno	篙
zloo	篙
zqo	篙
zfrs	篚
zqbb	篛
zqmm	篛
zwef	篜
zje	篝
zjny	篝
zwdi	篞
zwdy	篞
zphu	篟
zpit	篠
zpn	篠
zmdu	篡
zimb	篢
zgy	篣
zlnf	篣
zmf	篤
zct	篥
znbb	篦
zobb	篦
zpob	篦
znv	篧
zbat	篨
zbbh	篨
znv	篩
zpbn	篩
zren	篩
zyen	篩
zlzr	篪
zirh	篫
zizh	篫
zado	篬
zlil	篭
zlql	篭
zlob	篰
zla	篱
zlxu	篱
zwuu	篱
zffe	篲
zqjq	篳
zqj	篳
zqrj	篳
zqrq	篳
zeqw	篴
zezf	篶
zpfw	篷
zudm	篸
zum	篸
zuum	篸
zmdp	篹
zjpg	篺
zcrs	篻
zfpr	篼
zpdr	篼
zmip	篽
zfaa	篾
zfab	篾
zfav	篾
zcua	篿
zjqa	篿
zqa	篿
zxa	篿
zhmb	簀
zmiz	簁
zoae	簂
zoh	簂
zhcc	簃
zlps	簅
zwls	簅
znrp	簆
znru	簆
zfvd	簇
zcbg	簈
zcbk	簈
zcpg	簈
zcpk	簈
zsow	簉
zkby	簊
zdkf	簋
zjci	簌
zvsi	簌
zmg	簍
zjrd	簎
zlb	簏
zci	簐
zldk	簑
zmdu	簒
zmdw	簒
zeh	簘
zemr	簘
zerm	簘
zjaa	簙
zjia	簙
zfan	簚
zkbk	簛
zwdm	簜
zwe	簜
zdbs	簝
zla	簝
zbqj	簞
zoj	簞
zooj	簞
zcdj	簟
zxj	簟
zajf	簠
zif	簠
zmd	簡
zmw	簢
zceb	簣
zqa	簣
zfmb	簤
zma	簤
zgi	簥
zgno	簥
zgo	簥
zpdo	簥
zjd	簦
zka	簧
zreb	簧
zflb	簨
zolb	簨
zffd	簩
zkkd	簪
zeh	簫
zozo	簬
zduo	簭
zwbo	簭
zqad	簮
zqnd	簮
zppg	簰
zjbg	簳
zjdg	簳
zzfb	簴
zcpo	簵
znli	簷
zvo	簷
zkbp	簸
zsnq	簹
zso	簹
zqow	簻
zjjy	簼
zjj	簼
zac	簽
zae	簽
zaob	簽
zase	簽
zoa	簽
nbn	簾
nrn	簾
zlbf	簾
zlpq	簾
zlq	簾
zwaa	簿
zwia	簿
zjdq	籀
zjoq	籀
zrf	籃
zrvf	籃
zfcb	籄
zfq	籄
zea	籅
zlhq	籇
zlnq	籇
zloq	籇
zcyw	籈
zte	籉
zyop	籉
zeev	籊
zrx	籋
zfa	籌
zyya	籌
zd	籍
zlrd	籍
zubw	籐
zmda	籑
zmdk	籑
zwmq	籓
zmgp	籔
zuv	籗
zubs	籘
zacw	籙
zzqf	籚
zaaq	籛
zak	籛
zjfg	籜
zjfy	籜
zfoz	籝
zfua	籝
zfux	籝
zfuz	籝
zmih	籞
zmis	籞
zjcb	籟
zvsb	籟
zakp	籠
zal	籠
zlul	籠
zaop	籢
zop	籢
zmcs	籣
zmjs	籣
zmn	籣
zbbe	籤
zaom	籥
zagq	籦
zzew	籧
zzw	籧
zpmw	籩
zfwk	籪
zwwk	籪
zsrb	籫
zlv	籬
zlxv	籬
zwuv	籬
zla	籭
zllb	籭
zfc	籮
zfsv	籮
zfua	籯
zfuz	籯
zuvv	籱
ouj	籲
zaob	籲
zaot	籲
zb	籲
mn	米
bmn	籴
mjj	籵
mrl	籶
mrz	籶
mgl	籷
mzj	籸
mzx	籸
mgx	籹
mvz	籺
mdn	类
mei	籼
mzj	籽
maa	籿
mqx	粀
mgj	粁
mbl	粃
mlu	粄
mnm	粅
msp	粆
mlr	粇
mee	粈
mbd	粉
bmn	粊
mkj	粋
mqi	粌
mml	粍
mcl	粑
mle	粒
mgo	粓
mff	粔
mpd	粕
mqb	粖
mys	粖
mme	粗
mzo	粘
miq	粙
mva	粚
ehi	粛
emr	粛
erm	粛
eem	粜
eum	粜
mco	粞
cmn	粟
mrb	粠
mneo	粡
bim	粢
rim	粢
mmj	粣
mnne	粣
pomk	粤
qmq	粥
mcj	粦
mcs	粦
mly	粧
mtd	粨
madk	粮
man	粮
mmr	粯
mez	粰
wdam	粱
wdbm	粱
zcum	粲
mtqx	粳
mtx	粳
mqe	粴
pkv	粵
pnmk	粵
pomk	粵
uk	粵
mnm	粷
mkb	粸
mjj	粹
mpg	粺
mpqg	粺
mek	粻
mcr	粼
mcsr	粼
mnrs	粽
mns	粽
mhu	精
mqt	粿
mkbl	糂
mklb	糂
mklr	糂
mkl	糂
mkrl	糂
mdem	糃
mdvm	糃
mep	糃
mfm	糄
mmt	糅
mtoh	糆
mpfd	糇
mfbu	糈
myzu	糈
mxup	糉
mfu	糊
mjou	糊
mber	糋
mbi	糋
mpbd	糌
mppd	糌
mbew	糍
mrww	糍
mlq	糎
maja	糐
mia	糐
mqbb	糑
mqmm	糑
mrpq	糒
yneu	糓
ynmu	糓
muac	糔
mubc	糔
mbkf	糕
xbkf	糕
mleo	糖
mpmd	糗
msow	糙
mrgy	糚
msny	糛
lttm	糜
mudm	糝
mum	糝
muum	糝
mqrb	糞
mrb	糞
mrfd	糟
mrod	糟
mlew	糠
mldr	糡
mdv	糢
mrdd	糢
mkkd	糣
mydo	糦
myoo	糦
madk	糧
man	糧
mdeq	糧
mqoc	糨
mquc	糨
colm	糪
pmn	糪
mfh	糬
mfyd	糬
mrf	糮
mrvf	糮
mur	糯
mutr	糯
mcua	糰
mjqa	糰
moca	糰
moja	糰
mou	糰
mox	糰
eblm	糱
epbm	糱
mlru	糲
febm	糳
fgim	糳
fgrm	糳
figm	糳
bmev	糴
rabm	糵
rpbm	糵
eemv	糶
eumv	糶
mrms	糷
mrm	糷
sa	糸
sll	糺
esa	系
psa	系
sdx	糼
sdy	糼
sti	糽
sgi	糾
sdp	糿
sfl	紀
sax	紁
saa	紂
ssi	紃
sna	約
sie	紅
suj	紆
svz	紇
ska	紈
sza	紈
szx	紈
sda	紉
sdn	紉
wsa	紊
swx	紋
sak	紌
snb	納
sad	紎
sdj	紏
see	紐
sba	紑
sbr	紒
sui	紓
sel	純
sbl	紕
sqi	紖
ssp	紗
sxu	紘
sxx	紙
xnj	紙
spu	級
srn	級
sbd	紛
sta	紜
ske	紝
skl	紞
say	紟
hsa	素
sfy	紡
jns	索
ski	紤
jls	紥
spa	紨
ssn	紩
zfs	紫
siq	紬
squ	紭
tls	紮
qsa	累
sqo	細
saxx	紱
sax	紱
ssl	紲
sii	紳
siqi	紳
spx	紴
snt	紵
syu	紶
sap	紷
sat	紷
sak	紸
sdo	紹
sgo	紺
scn	紻
svj	紼
snf	紽
sbm	紾
suo	紿
see	絀
seu	絀
sva	絁
spb	終
slw	絃
sme	組
sno	絅
sbj	絆
sno	絇
spd	絈
sat	絉
ste	絊
stj	絊
ssi	経
sui	経
suy	経
spk	絍
smii	絎
smit	絎
siqx	絏
six	絏
sqx	絏
syo	結
ssb	絑
sss	絑
syyy	絒
syy	絓
std	絔
sdcl	絕
sdc	絕
sncl	絕
snc	絕
sser	絖
soo	絗
sbi	絘
sri	絘
sede	絙
sdae	絚
sede	絚
pips	絛
fds	絜
hds	絜
sdrk	絝
sxk	絝
slx	絞
sbk	絟
sxe	絠
sxu	絠
spo	絡
snd	絢
sbk	絣
sco	絤
sao	給
sneo	絧
saqj	絨
saqx	絨
sra	絩
srbb	絩
sod	絪
uds	絫
uuus	絫
sgo	絬
bns	絭
gos	絮
slh	絯
spe	絰
stl	統
str	統
ssa	絲
wwe	絲
sps	絳
sbh	絴
sad	絵
sbt	絵
sdcl	絶
sdc	絶
sncl	絶
snc	絶
smr	絸
sou	絹
sxxn	絺
sdcr	絻
sel	絻
sncr	絻
seq	絼
suq	絼
sopo	絽
sajw	絿
sna	絿
sjcs	綀
svs	綀
sfb	綁
ssu	綃
snrr	綄
senu	綅
srx	綅
stqx	綆
stx	綆
seo	綇
sbqp	綈
stp	綈
shr	綉
sgn	綊
snxu	綋
sbbo	綌
swo	綌
sjnz	綍
skw	綎
seg	綏
sbor	綐
sot	綑
sez	綒
sesi	經
ssi	經
sui	經
suy	經
drks	綔
xes	綔
xps	綔
syh	綕
spzw	綖
snbo	綗
snro	綗
spf	綘
slm	継
sml	継
snrs	綜
sns	綜
ss	綜
stt	綝
sge	綞
sgjy	綞
sfad	綟
scew	綠
sew	綠
xs	綠
slos	綡
sls	綡
sno	綢
snyo	綢
sbnp	綣
spl	綣
dobs	綤
kbs	綦
slhz	綧
sloz	綧
slz	綧
skb	綨
sncp	綩
shu	綪
saqq	綫
skx	綫
senu	綬
sve	維
fps	綮
sni	綯
snwu	綯
snb	綰
snbe	綱
snx	綱
nxx	網
snbf	網
xf	網
suu	綳
suuu	綴
set	綵
smn	綵
sqt	綶
sjj	綷
sam	綸
sbf	綸
spbo	綹
sppo	綹
sdto	綺
svo	綺
snez	綻
snz	綻
spg	綼
spqg	綼
sqj	綽
szdj	綽
sybp	綾
syrp	綾
syx	綾
pdns	綿
spdn	綿
spj	綿
sjeg	緀
sjg	緀
sjez	緁
sjz	緁
szez	緁
sff	緂
sdb	緄
sru	緅
sdnm	緆
sep	緆
ssq	緇
sybg	緈
syj	緈
seb	緉
senb	緉
rus	緊
srss	緋
shg	緌
sxd	緍
saqe	緎
she	緎
sbuh	総
scew	緑
sew	緑
sdv	緒
sho	緒
sypd	緒
sho	緖
syd	緖
sypd	緖
stm	緗
saqo	緘
sko	緘
src	緙
saf	線
saqq	線
skx	線
spdw	線
sv	線
swv	線
srd	緛
stnd	緛
pdns	緜
pes	緜
pps	緜
sor	緝
seru	緞
sgq	緟
slnn	締
soxd	緡
srq	緢
sceq	緣
seq	緣
sq	緣
sst	緤
spot	緥
sqh	緦
sbe	緧
sfm	編
segu	緩
sex	緩
shde	緪
shee	緪
snqh	緫
stoh	緬
squ	緭
svdp	緮
svx	緮
swj	緯
swos	緯
sai	緰
saur	緰
spfd	緱
sms	緲
lfds	緳
lhds	緳
scs	練
sjqs	練
sxup	緵
sptx	緶
spt	緶
snc	緷
scy	緸
sdez	緹
sjn	緹
sqo	緺
spp	緻
sdf	緼
sobf	緼
szmb	緽
slq	緾
suoh	緿
sofu	縀
sox	縀
sceq	縁
seq	縁
sboh	縂
sh	縂
sfbu	縃
syzu	縃
ffns	縈
rns	縈
sefd	縉
seud	縉
sod	縉
sbef	縊
sye	縊
spbw	縋
sbew	縌
sgy	縍
slnf	縍
squ	縎
zrus	縏
snee	縐
sne	縐
sbef	縑
sqn	縑
sbhi	縒
sbki	縒
slps	縓
sya	縓
suut	縔
sdf	縕
sobf	縕
snfo	縖
snho	縖
sldk	縗
srr	縙
seg	縚
saja	縛
sia	縛
somb	縜
sjb	縝
sjmb	縝
slho	縞
slno	縞
sloo	縞
sqo	縞
sfka	縟
yneu	縠
ynsu	縠
snl	縡
ubns	縢
mba	縣
mbes	縣
mbps	縣
mess	縣
mes	縣
mlss	縣
mls	縣
msa	縣
msps	縣
ms	縣
mua	縣
shs	縤
sfnh	縥
spip	縧
spit	縧
spn	縧
sja	縩
sjrs	縩
sqjq	縪
sqj	縪
sqrj	縪
sqrq	縪
spfw	縫
saqs	縬
sla	縭
slxu	縭
swuu	縭
sd	縮
snpd	縮
sna	縯
sneb	縯
smiz	縰
sbb	縱
smiz	縱
sz	縱
sqs	縲
scua	縳
sjqa	縳
sqa	縳
sxa	縳
slws	縴
sdfu	縵
smx	縵
jzs	縶
ybgs	縶
yzs	縶
smg	縷
srdd	縸
scrs	縹
scw	縺
ltts	縻
sfvz	縼
boh	總
sboh	總
sbuh	總
sh	總
spa	總
spoh	總
sg	績
shmb	績
sudm	縿
sum	縿
suum	縿
sev	繀
voms	繁
vsa	繁
slbj	繂
slj	繂
slwj	繂
seuu	繃
suu	繃
fvds	繄
ssqt	繅
seem	繆
sem	繆
ewus	繇
usa	繇
uues	繇
uups	繇
uwus	繇
sqoc	繈
squc	繈
smrb	繉
smr	繉
spop	繌
seh	繍
semr	繍
serm	繍
sflb	繏
solb	繏
sch	繐
scuh	繐
sjqh	繐
sgi	繑
sgno	繑
sgo	繑
spdo	繑
sbo	繒
sbqd	繒
sdeu	繓
sdru	繓
slad	織
sob	織
sbho	繕
sbko	繕
srup	繖
smcs	繗
smc	繗
smno	繘
smq	繙
sdbs	繚
sla	繚
hsq	繛
hszj	繛
sbea	繜
smu	繝
sqer	繞
syr	繞
syyr	繞
soj	繟
sooj	繟
hhhs	繠
seh	繡
ser	繡
shr	繡
sceb	繢
sqa	繢
seqe	繣
sqoc	繦
squc	繦
sybw	繨
syw	繨
soql	繩
sxl	繩
sad	繪
saqd	繪
sbt	繪
crus	繫
cs	繫
curs	繫
psa	繫
swoo	繬
rca	繭
rnsc	繭
seqe	繮
sfek	繯
son	繯
slt	繰
soot	繰
srnh	繱
snds	繲
qp	繳
spdp	繳
spv	繳
cols	繴
psa	繴
sloe	繵
slom	繵
sldh	繶
sffk	繷
snk	繷
srok	繷
sbew	繸
scn	繹
sfyg	繹
sfy	繹
suq	繹
snef	繺
sur	繻
sutr	繻
sfww	繼
slm	繼
slww	繼
sml	繼
swwf	繼
swwl	繼
sw	繼
sbv	繽
sncb	繽
snkb	繽
snpb	繽
snsb	繽
scew	繾
srf	繿
srvf	繿
spfd	纀
spv	纀
sgqf	纁
zmds	纂
spdt	纅
srn	纅
swpt	纅
sqfy	纆
mstb	纇
mst	纇
syob	纈
syot	纈
sqab	纉
sqnb	纉
slk	纊
slrb	纊
stdp	纋
stmp	纋
syx	纋
sb	續
sjm	續
sjyd	續
sxbd	續
syfb	續
sym	續
synr	續
qqqs	纍
qsv	纍
sjae	纎
slqy	纏
slq	纏
szqf	纑
slqy	纒
smbg	纓
ssg	纓
snoa	纔
snoe	纔
sln	纕
slok	纕
sbbe	纖
sgj	纖
sjae	纖
sevo	纗
ssrb	纘
sfsv	纙
sllb	纚
homs	纛
hoxs	纛
srfr	纜
srvr	纜
svl	纜
sish	纞
slfh	纞
ssih	纞
wui	缶
wui	缸
wuf	缹
wuj	缺
wuw	缻
ate	缽
wute	缽
wubk	缾
wufo	缿
wune	罁
ffne	罃
ffnu	罃
ycre	罄
ycru	罄
ywu	罄
wuzh	罅
wuba	罇
wucj	罈
wux	罈
crue	罊
cruu	罊
cure	罊
curu	罊
lwve	罋
lwvu	罋
mbme	罌
mbmu	罌
swu	罌
qqqe	罍
qqqu	罍
wudt	罎
wuzf	罏
wurv	罐
wur	罐
nxx	网
nbef	罔
nbf	罔
nbil	罔
nbtf	罔
nbg	罕
nrg	罕
fba	罘
nbt	罙
nn	罙
nrt	罙
fga	罛
fgn	罛
fak	罜
fme	罝
fmp	罞
fjo	罟
fox	罠
fez	罡
fyu	罢
fyy	罣
fou	罥
fez	罦
ftt	罧
fdil	罨
fdql	罨
fxl	罨
fqj	罩
fzdj	罩
frss	罪
us	罪
fyyp	罫
fuuu	罬
faqe	罭
fhe	罭
fje	置
fjl	置
fjme	置
fjml	置
fld	罯
fir	罰
fjng	罱
fnj	罱
fho	署
fypd	署
fqh	罳
fmf	罵
oomf	罵
fddq	罶
foq	罶
ful	罷
fuuf	罷
fyu	罷
fia	罸
fhv	罹
fsqt	罺
fca	罻
fcra	罻
fqjq	罼
fqj	罼
fqrj	罼
fqrq	罼
flfr	罽
fbo	罾
fbqd	罾
flq	罿
frdn	羃
fca	羅
fsv	羅
fuf	羆
fuuf	羆
fyuf	羆
frco	羇
frcv	羇
frcf	羈
fiss	羉
fsis	羉
bhj	羊
bbq	羋
iyzg	羋
rqj	羋
yizg	羋
yvq	羋
yzq	羋
bkr	羌
dbh	羍
bkd	美
bhm	羏
bknn	羑
bhbd	羒
bhcl	羓
bhc	羓
bkf	羔
bku	羕
bkw	羕
bhru	羖
bkru	羗
bkf	羙
bhap	羚
bhat	羚
bkv	羛
bhnt	羜
bhxe	羝
bhe	羞
bkpe	羞
bhe	羠
bhjb	羠
bkbi	羡
bkri	羡
bhaj	羢
bhax	羢
eobh	羣
eh	群
eobh	群
bhei	羥
bhsi	羥
bhui	羥
bhuy	羥
bhnr	羦
bhh	羧
bhup	羧
biv	羨
bkbi	羨
bkri	羨
bkwi	羨
axx	義
bki	義
bx	義
bhao	羬
bhk	羬
bhar	羭
bha	羭
bkfb	羮
bkfd	羮
bhdl	羯
bhd	羯
bhef	羰
bhls	羱
bhy	羱
bkik	羲
bkir	羲
bkk	羲
brp	羲
bhmq	羳
bhbh	羴
bhjb	羵
bhj	羵
bhle	羶
bhlm	羶
bhab	羷
bha	羷
bho	羷
foua	羸
fouz	羸
fuba	羸
fubz	羸
bkfd	羹
bhur	羺
bhlp	羻
cbhh	羼
eee	羽
eep	羽
eei	羾
eer	羿
eec	翀
bev	翁
buee	翁
eebd	翂
xuee	翃
eeju	翄
juee	翅
eekj	翆
eeax	翇
eea	翇
teee	翉
lee	翊
eel	翋
eel	翌
eep	翍
apee	翎
atee	翎
eebm	翏
emp	翏
eesn	翐
eeno	翑
ed	習
eepd	習
ee	習
yoee	翓
bhee	翔
aoee	翕
aoee	翖
ccee	翗
pipe	翛
eeg	翜
nxue	翝
eels	翞
eev	翟
eejj	翠
rsse	翡
nee	翢
nyoe	翢
eelg	翣
hee	翥
ypae	翥
ypde	翥
bee	翦
beue	翦
nede	翧
neee	翧
eedz	翨
eej	翨
fmee	翩
eexp	翪
eepr	翫
eenc	翬
eepd	翭
eone	翮
eelo	翯
jbee	翰
jdje	翰
pdde	翱
pdje	翱
pdre	翱
pdte	翱
pdwe	翱
pmde	翱
pmte	翱
pmwe	翱
crse	翲
fvde	翳
eecw	翴
eenf	翵
mcee	翷
mcse	翷
jee	翸
jrme	翸
qere	翹
yree	翹
yyye	翹
pmbe	翺
pmre	翺
pmwe	翺
mev	翻
mqee	翻
ebv	翼
eeqb	翼
zaqe	翽
zee	翽
feoe	翾
oee	翾
yyie	翿
serv	耀
svv	耀
ypf	老
rk	考
ypk	考
ypfm	耄
ho	者
ypad	者
ypd	者
ypfd	耆
ypno	耇
ypfo	耈
ypp	耊
ypfp	耋
ri	而
tnr	而
rgx	耍
tnrg	耍
rdn	耎
tnrd	耎
rmp	耏
tnrm	耏
raa	耐
ra	耐
tnra	耐
di	耑
eri	耑
etnr	耑
ln	耒
lzj	耔
ljj	耕
ljv	耕
lsp	耖
lml	耗
lta	耘
lcl	耙
lpx	耚
luo	耛
lbo	耜
lme	耝
ldo	耞
lff	耟
lmd	耡
lam	耣
lrd	耤
lqnu	耦
lfka	耨
lje	耩
ljny	耩
lgy	耪
llnf	耪
lhmb	耫
lmg	耬
lffd	耮
lrnd	耮
lrvu	耯
ltdp	耰
ltmp	耰
lyx	耰
rj	耳
rll	耴
rti	耵
rbi	耶
drj	耷
ray	耹
rze	耻
rnr	耼
rue	耼
rkl	耽
rnr	耽
rxu	耾
rfn	耿
raq	聀
rny	聃
rbm	聄
rvd	聅
rap	聆
rat	聆
rez	聇
rwd	聈
ree	聉
reu	聉
rdp	聊
rra	聎
rrbb	聎
rri	聏
rtnr	聏
ryo	聐
rrj	聑
rgo	聒
rok	聖
uye	聖
rgn	聗
riqk	聘
rkv	聘
rqk	聘
rumk	聚
rupb	聚
ruq	聚
rpg	聛
rpqg	聛
rnbi	聜
rnri	聜
raqe	聝
rhe	聝
mrj	聞
vdor	聟
rbgg	聠
rbk	聠
rpgg	聠
rbuh	聡
rlht	聤
rlnt	聤
rlot	聤
rpcu	聥
rnqh	聦
rjed	聧
rjgn	聧
rkn	聧
rwwr	聨
rboh	聪
rwwd	聫
rbue	聬
rss	聮
rwwf	聮
rbed	聯
rbgn	聯
rf	聯
rgn	聯
rwwf	聯
rboh	聰
rpa	聰
rpoh	聰
hnpr	聱
yfpr	聱
ycp	聲
ycrr	聲
yc	聲
yrj	聲
bbr	聳
mibr	聳
rja	聴
rjfh	聴
rceb	聵
rqa	聵
rrr	聶
ruu	聶
rlad	職
rob	職
rnli	聸
rvo	聸
rnht	聹
rnt	聹
rnjs	聺
rnj	聺
wckr	聻
irjh	聼
irj	聼
trjh	聼
trj	聼
oki	聽
rh	聽
rjfh	聽
rkjh	聽
rkj	聽
akpr	聾
arj	聾
lulr	聾
ejv	聿
ej	聿
dej	肂
fvde	肄
ehi	肅
ehp	肅
eue	肆
euf	肆
fpe	肇
nbb	肉
uzl	肊
uzz	肊
udx	肋
udy	肋
url	肌
urz	肌
ukl	肍
ukx	肍
ukz	肍
nue	肎
bnbb	肏
uvz	肐
una	肑
une	肑
uka	肒
uza	肒
uzx	肒
fue	肓
fuv	肓
ual	肔
uda	肕
udn	肕
sue	肖
ugx	肗
uaa	肘
oue	肙
uye	肚
uie	肛
ump	肜
ugj	肝
uru	股
uju	肢
uay	肣
uqn	肤
ucl	肥
ubd	肦
uba	肧
ufj	肨
fue	肩
ufy	肪
uel	肫
uak	肬
unb	肭
ulr	肮
zue	肯
uad	肰
uxu	肱
tue	育
unm	肳
xxe	肴
xxu	肴
uki	肵
ubl	肶
ubj	肸
ujn	肺
uln	肺
uii	胂
uiqi	胂
que	胃
quv	胃
iqu	胄
usn	胅
ude	胆
uvj	胇
uaxx	胈
uax	胈
upd	胉
uno	胊
uzo	胋
ffu	背
uga	胍
uuo	胎
ujp	胏
uee	胐
ueu	胐
uob	胑
ucf	胒
upj	胓
zfnb	胔
upa	胕
ubj	胖
ubm	胗
ulw	胘
uvf	胙
ube	胚
uqi	胛
use	胜
uxe	胝
unl	胞
unol	胞
uom	胟
uyu	胠
fu	胡
jou	胡
uto	胢
uva	胣
pwul	胤
rwu	胤
fbu	胥
yzu	胥
ucn	胦
uod	胭
ups	胮
udrk	胯
uxk	胯
uen	胰
ujqb	胰
user	胱
ulh	胲
upo	胳
uneo	胴
upe	胵
ulx	胶
nxuu	胷
unxu	胸
uri	胹
utnr	胹
ung	胺
umii	胻
umit	胻
ubk	胼
ul	能
uuff	能
jaqb	胾
uyy	胿
weu	脀
ura	脁
urbb	脁
ufd	脂
udcl	脃
udc	脃
uncl	脃
unc	脃
ulf	脄
uxf	脄
dddu	脅
duv	脅
udb	脅
unlp	脆
unp	脆
uddd	脇
ulk	脈
uun	脈
uun	脉
bbbu	脊
bfu	脊
brru	脊
fbu	脊
rbru	脊
wbu	脊
lfnb	脔
udcr	脕
uel	脕
uncr	脕
ujnz	脖
unmo	脗
unrr	脘
uajw	脙
una	脙
uyup	脚
uz	脚
uesi	脛
usi	脛
uui	脛
uuy	脛
ulhw	脝
ulow	脝
ulw	脝
ubby	脞
uea	脟
uua	脟
ukw	脡
uvom	脢
fku	脣
ufk	脤
ugn	脥
uhx	脧
uubp	脧
uurp	脧
pipu	脩
uxxn	脪
ubor	脫
ur	脫
uez	脬
uok	脭
ueg	脮
uajq	脯
uij	脯
ude	脰
ubor	脱
ur	脱
ubo	脴
uek	脹
ujj	脺
ujez	脻
ujz	脻
uve	脽
ug	脾
upg	脾
upqg	脾
uam	腀
ubgg	腁
ubk	腁
upgg	腁
uqt	腂
ubnl	腃
ubnp	腃
upl	腃
uge	腄
ugjy	腄
uff	腅
ufb	腆
urob	腆
uhg	腇
uhu	腈
ugr	腉
urd	腊
ulpu	腋
ulx	腋
udil	腌
udql	腌
uxl	腌
uayh	腍
ruu	腎
uuuu	腏
lbv	腐
lpab	腐
ulpa	腑
ucjo	腒
urss	腓
unbi	腔
unri	腔
uncp	腕
ucp	腛
ugt	腜
urd	腝
utnd	腝
uceq	腞
unp	腟
ufnd	腠
ufn	腠
uqo	腡
uqnu	腢
ulnn	腣
uld	腤
uds	腥
ulxu	腦
uso	腦
uspo	腦
uspx	腦
uswu	腦
usxu	腦
usx	腦
uwu	腦
uai	腧
uaur	腧
ujng	腩
unj	腩
unc	腪
uci	腫
ucj	腫
ugq	腫
umt	腬
uok	腭
uook	腭
uqh	腮
ukm	腯
uxm	腯
ucg	腰
uvx	腰
uew	腱
uqk	腲
ubbp	腳
upv	腳
up	腳
uwp	腳
uyup	腳
uz	腳
ugb	腴
uofu	腵
uox	腵
ueru	腶
ueoq	腷
udem	腸
udvm	腸
uep	腸
uvdp	腹
uvx	腹
updw	腺
udf	腽
uobf	腽
udkw	腿
ugy	膀
ulnf	膀
ubef	膁
uqn	膁
fvku	膂
udf	膃
uobf	膃
ugiu	膄
ugu	膄
uigu	膄
uhs	膆
upbw	膇
ueot	膈
ubef	膉
uye	膉
uaja	膊
uia	膊
ffnu	膋
ubbu	膌
ubfu	膌
ubru	膌
ufbu	膌
urbu	膌
uwbu	膌
uwnu	膌
upob	膍
lhnu	膏
lnou	膏
lonu	膏
luv	膏
que	膏
ufoo	膒
ufx	膒
uvdm	膓
uve	膓
ulb	膔
uoae	膕
uoh	膕
upfw	膖
uev	膗
ucrs	膘
uqoc	膙
uquc	膙
uqn	膚
zqu	膚
usny	膛
udv	膜
urdd	膜
utbw	膝
utw	膝
ucua	膞
ujqa	膞
uqa	膞
uxa	膞
ulbj	膟
ulj	膟
ulwj	膟
ueem	膠
uem	膠
ulx	膠
ubnm	膡
umg	膢
unbp	膣
unrp	膣
umcs	膦
umc	膦
ulq	膧
umv	膨
uydm	膨
uyom	膨
uaxb	膩
ulno	膪
udbs	膫
ula	膫
ummm	膬
uceb	膭
uqa	膭
uyr	膮
uyyr	膮
ujd	膯
umq	膰
ulad	膱
uvf	膲
ubho	膳
ubko	膳
xbko	膳
uek	膴
ugl	膴
uvff	膴
urjj	膵
uwab	膷
uxi	膷
uxiw	膸
uja	膹
ujrb	膹
lpvu	膺
uloe	膻
ulom	膻
uqow	膼
ude	膽
unli	膽
uvo	膽
uad	膾
uaqd	膾
ubt	膾
uffk	膿
unk	膿
urok	膿
uttk	膿
crbu	臀
cuv	臀
colu	臂
pue	臂
ulwv	臃
uzeq	臄
uzn	臄
ufnc	臅
uldh	臆
uzl	臆
uzz	臆
uvm	臇
uvu	臇
urdl	臈
urd	臈
uac	臉
uae	臉
uaob	臉
uase	臉
uoa	臉
ult	臊
uoot	臊
uydu	臌
uyou	臌
uwh	臍
uwr	臍
ueej	臎
ubv	臏
uncb	臏
unsb	臏
ugqf	臐
uur	臑
uutr	臑
urvu	臒
urub	臔
ulbf	臕
sebu	臖
unra	臗
urd	臘
usfs	臘
usl	臘
usos	臘
urff	臙
urof	臙
uzqf	臚
uuv	臛
foua	臝
fouz	臝
fuqa	臝
fuqz	臝
ummv	臞
uly	臟
urar	臟
urv	臟
issb	臠
lfnb	臠
sisb	臠
rcvb	臡
usrb	臢
re	臣
rbn	臥
rpa	臥
fifr	臦
rre	臦
aqgr	臧
rvac	臨
rvec	臨
rvoc	臨
rvoo	臨
rv	臨
fifr	臩
rrdr	臩
pmo	自
pm	自
pmt	臬
pmad	臭
pmmk	臮
pmpb	臮
pmq	臮
amrj	臯
amwj	臯
pmrj	臯
pmwj	臯
pmtp	臲
pe	至
ppx	致
pxiz	臶
jaqp	臷
ppe	臸
paqn	臹
pay	臹
te	臺
yonp	臺
pfnh	臻
ge	臼
gbn	臾
gge	臿
ege	舀
grj	舁
fng	舂
gkf	舃
gkf	舄
gnf	舄
gdv	舅
gqd	舅
ea	與
pobb	興
seb	興
ehj	舉
eqj	舉
eq	舉
sebq	舉
ido	舊
rg	舊
rvg	舊
snm	舋
goo	舌
bgo	舍
bov	舍
bo	舍
byo	舍
bgo	舎
bo	舎
byo	舎
gox	舐
gony	舑
bgou	舒
bui	舒
bu	舒
godm	舓
goe	舓
goef	舔
goeh	舔
gogf	舔
gogh	舔
gopf	舔
goph	舔
goff	舕
bajq	舖
bgoi	舖
bgoq	舖
bij	舖
byoi	舖
byoq	舖
bgob	舘
bnb	舘
gogo	舙
goni	舚
gov	舚
cj	舛
csj	舛
encs	舜
enc	舜
esv	舜
wsns	舝
vfcs	舞
vfc	舞
vs	舞
za	舟
zdp	舠
zie	舡
zei	舢
zra	舤
zcl	舥
zpra	舧
zlu	舨
zbu	舩
zlr	航
zfy	舫
zru	般
zu	般
zbl	舭
zci	舯
zcj	舯
zap	舲
zat	舲
ziq	舳
zvf	舴
znf	舵
zpd	舶
zlw	舷
zto	舸
zbo	船
zro	船
zqi	舺
zrb	舼
zps	舽
zdrk	舿
zxk	舿
zez	艀
zso	艁
zpf	艂
zsu	艄
zat	艅
zbh	艅
zkw	艇
zcm	艉
zpdn	艊
zpj	艊
zzf	艋
zayh	艌
zpdk	艎
zbtm	艏
zho	艏
zxup	艐
zfm	艑
zdm	艒
zst	艓
zgy	艕
zlnf	艕
zbhi	艖
zbki	艖
zbef	艗
zye	艗
zgiu	艘
zgu	艘
zado	艙
zbp	艙
zrfd	艚
zrod	艚
zmg	艛
zfnn	艜
zzrb	艞
zzr	艞
zlq	艟
zsnq	艡
zso	艡
zwoo	艢
zzqd	艣
zbki	艤
zbx	艤
zoar	艥
zorq	艥
gf	艦
zmr	艦
zrf	艦
zrvf	艦
zrnq	艨
zwh	艩
zufd	艪
zzqf	艫
znoa	艬
zvvu	艭
dkn	艮
adk	良
an	良
rcdk	艱
udk	艱
dcl	色
ncl	色
vdcl	艴
vdc	艴
vncl	艴
vnc	艴
bkdc	艵
bkdl	艵
bknc	艵
bknl	艵
fddc	艶
fddl	艶
fdnc	艶
fdnl	艶
rorc	艶
rorl	艶
fcv	艷
fddc	艷
fddl	艷
fdnc	艷
fdnl	艷
ffec	艷
ffel	艷
fifc	艷
fifl	艷
fncl	艷
fnc	艷
iffc	艷
iffl	艷
rorl	艷
eej	艸
rdx	艻
rdy	艻
rti	艼
rkl	艽
rkx	艽
rkz	艽
rxx	艾
rrp	艿
rdp	芀
rra	芃
rka	芄
rza	芄
rzx	芄
rax	芅
rax	芆
rbx	芆
rgj	芊
ruj	芋
rrk	芌
rna	芍
rqk	芎
rqy	芎
rye	芏
rfa	芐
rfl	芑
rfl	芒
rzj	芓
eee	芔
rca	芕
rbl	芘
rqn	芙
rel	芚
rex	芛
rek	芜
rgl	芜
rkl	芜
raz	芝
rkl	芞
rkz	芞
rru	芟
rwx	芠
rin	芡
rpr	芢
rba	芣
rzl	芤
rbr	芥
rfp	芦
rui	芧
rpu	芨
rrn	芨
ray	芩
rxx	芪
rrr	芫
rbd	芬
rcl	芭
rnb	芮
rha	芯
rju	芰
rpf	花
rbf	芲
rfy	芳
rnm	芴
rjn	芵
rnu	芶
rze	芷
rta	芸
rki	芹
rgn	芺
rpd	芺
nee	芻
nene	芻
rml	芼
rxp	芽
ryp	芽
rjn	芾
rln	芾
rlr	苀
rfn	苂
rxu	苃
rlp	苄
rqip	苐
rqp	苐
rtp	苐
rcp	苑
rnr	苒
rny	苒
rap	苓
rat	苓
ruo	苔
rdo	苕
riq	苖
rqo	苗
rno	苘
rle	苙
rto	苛
rmo	苜
rff	苝
rnl	苞
rnol	苞
rno	苟
rox	苠
rua	苡
rub	苡
run	苡
rbo	苢
rff	苣
rbe	苤
roo	若
rxo	若
rjo	苦
rnt	苧
rcf	苨
rpd	苩
renb	苪
ren	苪
rzo	苫
rob	苬
rwd	苭
rpe	苮
rte	苯
rqu	苰
rcn	英
rvf	苲
rpb	苳
rme	苴
rsn	苵
rbs	苶
rgo	苷
rhj	苸
rpj	苹
rom	苺
rpa	苻
rse	苼
rga	苽
rgn	苽
rhp	苾
rvj	茀
ree	茁
reu	茁
raqp	茂
rpv	茂
rwfl	范
rwp	范
rdo	茄
rmp	茅
rdp	茆
raxu	茇
raxx	茇
rax	茇
rzf	茈
rqb	茉
rys	茉
rxe	茋
rpy	茌
rno	茍
ruy	茎
rpo	茖
rco	茗
rddd	茘
raqj	茙
raqx	茙
rdk	茛
rco	茜
rre	茞
rej	茟
rpt	茠
rnz	茡
rdr	茢
rokd	茣
rcc	茤
ryy	茥
rjns	茦
rjn	茦
rca	茧
rbi	茨
rri	茨
rfo	茩
rser	茪
rwf	茫
rxiy	茬
rlx	茭
rpad	茯
rsb	茱
rss	茱
beww	茲
rww	茲
rwi	茳
roo	茴
rod	茵
rbt	茶
rpaq	茷
rrj	茸
rgo	茹
rtl	茺
rtr	茺
eeee	茻
rneo	茼
rira	茿
riz	茿
rnd	荀
rede	荁
rdrk	荂
rxk	荂
rbk	荃
rlh	荄
rao	荅
rggr	荆
rkr	荆
rmii	荇
rmit	荇
rcj	荈
rcs	荈
rdj	草
rkr	荊
rri	荋
rtnr	荋
rng	荌
rgp	荍
rpe	荎
rpk	荏
riz	荐
rxiz	荐
rzv	荐
ren	荑
rjqb	荑
rfs	荒
rbk	荓
rddd	荔
rypf	荖
raqa	荗
raqb	荗
raqv	荗
rbiy	荘
rgy	荘
ffnt	荣
rnt	荣
snt	荣
rcm	荱
rqe	荲
rde	荳
rjqn	荴
rdah	荵
roay	荶
rpto	荷
rjnz	荸
rzs	荹
rynb	荺
rynr	荺
rqf	荻
rat	荼
rbh	荼
rtn	荼
reg	荽
rhx	荾
rubp	荾
rurp	荾
raqn	荿
ray	荿
rfk	莀
rwe	莁
rxxn	莃
rtqx	莄
rtx	莄
rpl	莅
rajq	莆
rij	莆
rmd	莇
rwnu	莈
rwru	莈
rhr	莉
rgy	莊
rpvf	莋
rbor	莌
rajw	莍
rna	莍
rws	莎
rjs	莏
rwk	莐
rwnr	莐
rpf	莑
ropo	莒
rvom	莓
robn	莔
rorn	莔
rto	莕
resi	莖
rsi	莖
rui	莖
ruy	莖
rcj	莗
rlj	莘
reo	莙
rpzw	莚
rkw	莛
rpip	莜
rbby	莝
rnrr	莞
rayo	莟
ryo	莟
rhr	莠
roz	莡
rgn	莢
rfh	莣
reo	莤
rqe	莥
rsu	莦
rmr	莧
radk	莨
ran	莨
rez	莩
rix	莪
rdd	莫
rdup	莭
rgi	莭
rqd	莮
rwt	莯
ryi	莰
radr	莽
rdr	莽
rjnr	莿
rjr	莿
rncp	菀
rhu	菁
rda	菂
rpda	菂
rwff	菃
rcs	菄
rjqs	菄
rnb	菅
rru	菆
rgjo	菇
rjl	菈
rcew	菉
rnm	菊
roqb	菋
roys	菋
roh	菌
rayh	菍
ryh	菍
rdb	菎
rwto	菏
rsq	菑
rdt	菒
rqt	菓
rupu	菔
ram	菕
rdd	菖
rjiq	菗
rtbu	菘
rge	菙
rgjy	菙
raqq	菚
rkx	菚
rmi	菛
rmy	菛
ret	菜
rmn	菜
rjax	菝
rja	菝
rhd	菞
rdca	菟
rea	菟
rnca	菟
rwp	菠
rkbu	菡
rwu	菡
rjnl	菢
rjn	菢
rru	菣
rbnl	菤
rbnp	菤
rpl	菤
rtk	菥
rkw	菦
rlxe	菧
rlg	菨
rlo	菩
rnlo	菪
rce	菫
rwdo	菬
rwuo	菭
rleb	菮
rlen	菮
aj	華
pfj	華
rjjq	華
rrj	華
rrq	華
rzg	菰
rybp	菱
ryrp	菱
ryx	菱
rrss	菲
rae	菳
rdil	菴
rdql	菴
rxl	菴
rnbf	菵
rfnq	菶
rfbb	菸
rwm	菹
rfu	菺
rtt	菻
rff	菼
rfsu	菽
redf	菾
redh	菾
rgnf	菾
rgnh	菾
rpdf	菾
rpdh	菾
rpr	菿
rzr	萀
rkb	萁
rho	萂
rjj	萃
rni	萄
rnwu	萄
red	萅
rpg	萆
rpqg	萆
rek	萇
rmra	萈
rucl	萉
ruc	萉
rln	萊
rjeg	萋
rjg	萋
rdu	萌
rwp	萍
rhg	萎
rdg	萏
rng	萏
rjez	萐
rjz	萐
rzez	萐
rve	萑
rlur	萒
rnm	萓
rjdo	萔
rgr	萖
rnrs	萗
rns	萗
rdrs	萘
rmr	萛
rnez	萣
rnz	萣
rhf	萩
rhd	萪
rhd	萫
rqnu	萬
ru	萬
vy	萬
rpcu	萭
rai	萮
raur	萮
rur	萮
rdmb	萯
rnmb	萯
rcs	萰
rjqs	萰
rnee	萱
rne	萱
regu	萲
rex	萲
rjng	萳
rmbr	萴
ronb	萵
rqo	萵
rfnd	萶
rsur	萷
rgb	萸
rfm	萹
rdm	萺
rld	萻
rok	萼
rook	萼
ro	落
rwpo	落
rruf	萾
rwpf	萾
rwgo	萿
rjgo	葀
rbkg	葁
rdcd	葂
red	葂
rncd	葂
rdvf	葃
ruvf	葄
rbbm	葅
rpot	葆
rmt	葇
ruot	葈
ojj	葉
rst	葉
raor	葊
ror	葊
runo	葋
rggg	葌
reoq	葍
rmie	葎
rwe	葏
rbdf	葐
ryya	葑
rsi	葒
rwrb	葓
rpfd	葔
rmii	葕
rmit	葕
rnbd	葖
rnrd	葖
bhm	著
bkpm	著
rd	著
rho	著
rypd	著
rseq	葘
rtm	葙
rkbl	葚
rklb	葚
rklr	葚
rkl	葚
rkrl	葚
rdl	葛
rdnl	葛
rfdd	葜
rhdd	葜
resd	葝
rqr	葞
rpdk	葟
rpeu	葠
rpr	葠
rnaq	葡
rni	葡
rdaf	葢
rgq	董
rsa	葤
rber	葥
rbi	葥
rwj	葦
rwos	葦
rjnd	葧
rqk	葨
rpdc	葩
rpdl	葩
rfu	葫
rjou	葫
rdfr	葬
recf	葬
rofu	葭
rox	葭
reru	葮
rsna	葯
rph	葰
rpup	葰
rnqh	葱
rpdw	葲
raqg	葳
raqo	葴
rko	葴
rjed	葵
rjgn	葵
rkn	葵
rlht	葶
rlnt	葶
rlot	葶
rnc	葷
rqh	葸
rfva	葹
ror	葺
rrc	葻
rcg	葽
rvx	葽
rcph	葾
rcm	葿
rdf	蒀
robf	蒀
rlnn	蒂
rceq	蒃
req	蒃
rnra	蒄
rirg	蒆
rizg	蒆
rbwf	蒍
rewf	蒍
rwa	蒍
rywf	蒍
rwlk	蒎
rne	蒏
rpqu	蒐
rpru	蒐
rva	蒐
rpdu	蒑
rpbn	蒒
rren	蒒
ryen	蒒
rse	蒓
rdya	蒔
rdf	蒕
robf	蒕
rjb	蒖
rjmb	蒖
rwak	蒗
rwa	蒗
rgoh	蒘
qq	蒙
rnrq	蒙
reot	蒚
rwuj	蒛
rrss	蒜
rlps	蒝
rya	蒝
rpl	蒞
rwpl	蒞
rlno	蒟
rpmh	蒠
rgy	蒡
rlnf	蒡
rbat	蒢
rbbh	蒢
rmih	蒣
rmit	蒣
rwat	蒤
rwbh	蒤
rddq	蒥
roq	蒥
raqo	蒧
rphu	蒨
rhm	蒩
raja	蒪
ria	蒪
rbhi	蒫
rbki	蒫
rnda	蒬
rnea	蒬
rnna	蒬
rnee	蒭
rnv	蒮
ruur	蒯
rzru	蒰
rjaq	蒱
rji	蒱
rwaq	蒲
rwi	蒲
rsnb	蒳
rbeu	蒴
rewd	蒵
rsbd	蒶
romb	蒷
rwef	蒸
rbef	蒹
rqn	蒹
rlbd	蒺
rqbb	蒻
rqmm	蒻
rado	蒼
rodh	蒽
rlho	蒿
rlno	蒿
rloo	蒿
rqo	蒿
rzes	蓀
rzps	蓀
rzs	蓀
rfnh	蓁
rndl	蓂
rgiu	蓃
rgu	蓃
rigu	蓃
rlwq	蓄
xq	蓄
rwts	蓅
rlrn	蓆
rqu	蓇
rab	蓈
radb	蓈
rnbo	蓉
rnw	蓉
rbue	蓊
bkf	蓋
rce	蓋
ryuf	蓋
rbbp	蓌
rypd	蓍
rleo	蓎
rgg	蓏
rfka	蓐
rldk	蓑
rcg	蓒
rplo	蓓
rbkf	蓔
rtyy	蓕
rpob	蓖
rmiz	蓗
rlbk	蓘
rluk	蓘
rpim	蓚
rpp	蓚
rjcp	蓛
rjnp	蓛
rjp	蓛
rpit	蓧
rpn	蓧
rpiu	蓨
rmpd	蓩
rtnw	蓪
rtn	蓪
rtw	蓪
reqw	蓫
rpfw	蓬
rldl	蓭
rlx	蓭
rcw	蓮
rmiz	蓯
rmiz	蓰
rwbk	蓱
rfoo	蓲
rrc	蓳
rcua	蓴
rjqa	蓴
rqa	蓴
rxa	蓴
rjjz	蓵
rov	蓶
rjv	蓷
rrfd	蓸
rrod	蓸
rmip	蓹
ryba	蓺
rybz	蓺
ryra	蓺
ryrz	蓺
ryz	蓺
rjz	蓻
ryba	蓻
rybz	蓻
ryz	蓻
reem	蓼
rem	蓼
rqjq	蓽
rqj	蓽
rqrj	蓽
rqrq	蓽
rzof	蓾
rzox	蓾
rnpd	蓿
rlob	蔀
rldj	蔁
rqs	蔂
rqoc	蔃
rquc	蔃
rmo	蔄
rmg	蔅
rwyp	蔆
rwy	蔆
rdl	蔇
rduk	蔇
rcrs	蔈
rlok	蔉
rlrk	蔉
rfdg	蔊
rwfu	蔋
rjci	蔌
rvsi	蔌
rlb	蔍
riru	蔎
rlno	蔏
rxo	蔏
rfaa	蔑
rfab	蔑
rfae	蔑
rfav	蔑
reof	蔒
rdfu	蔓
rmx	蔓
rneq	蔔
rfnn	蔕
rzm	蔖
rlrf	蔗
rudm	蔘
rum	蔘
ruum	蔘
rfvz	蔙
rca	蔚
rcra	蔚
rnd	蔛
rhnp	蔜
ryfp	蔜
rmm	蔝
rmg	蔞
rfvd	蔟
rspb	蔠
rja	蔡
rjrs	蔡
rgca	蔣
rgea	蔣
rgua	蔣
rnhe	蔤
rboh	蔥
rnqh	蔥
rpa	蔥
rpoh	蔥
rnf	蔦
rffe	蔧
robp	蔨
rop	蔨
rna	蔩
rneb	蔩
rck	蔪
rezf	蔫
rsv	蔬
rys	蔬
ryzs	蔬
rbat	蔭
rbau	蔭
rbbu	蔭
rbu	蔭
roae	蔮
roh	蔮
rbcs	蔯
rbjs	蔯
rfoc	蔰
rfol	蔰
rxau	蔱
rxtu	蔱
rwhl	蔳
rwhu	蔳
rltt	蔴
raqr	蔵
rrv	蔵
rnru	蔻
rbx	蔽
rsnp	蔽
rhdt	蔾
rbwf	蔿
rewf	蔿
rjj	蕀
rjns	蕀
reia	蕁
rubd	蕂
rmq	蕃
rmh	蕄
rwqu	蕅
raqb	蕆
roj	蕇
rooj	蕇
rcdj	蕈
rxj	蕈
rvf	蕉
rhhh	蕊
rzzz	蕋
rddd	蕌
rwar	蕍
rwa	蕍
rgi	蕎
rgno	蕎
rgo	蕎
rpdo	蕎
rmu	蕑
rut	蕓
rjpu	蕔
rybu	蕔
rypu	蕔
rqbe	蕕
rwft	蕖
rozo	蕗
ryr	蕘
ryyr	蕘
rch	蕙
rcuh	蕙
rjqh	蕙
rook	蕚
roo	蕚
rhbp	蕛
rht	蕛
rrsh	蕜
rsdc	蕝
rsdl	蕝
rsnc	蕝
rsnl	蕝
rdeu	蕞
rdru	蕞
rfx	蕟
rjqu	蕟
rgos	蕠
rja	蕡
rjrb	蕡
rceb	蕢
rqa	蕢
renc	蕣
rens	蕣
reqs	蕤
rxv	蕥
ryv	蕥
rmtb	蕦
rmt	蕦
rmip	蕧
rmiv	蕧
rlbi	蕨
rwdm	蕩
rwe	蕩
rek	蕪
rgl	蕪
rvff	蕪
rlq	蕫
rss	蕬
reh	蕭
rgnf	蕮
rbps	蕯
rwdf	蕰
rwof	蕰
rhsu	蕱
rcx	蕵
ruap	蕶
ruat	蕶
rua	蕷
rutb	蕷
rut	蕷
rofw	蕸
row	蕸
rlwv	蕹
rorq	蕺
reub	蕻
reue	蕼
ruq	蕾
rfep	蕿
rfeu	蕿
rfe	蕿
rwdf	薀
rwof	薀
rpnd	薁
rpob	薁
rpdp	薂
rwlo	薃
rwaa	薄
rwia	薄
xr	薄
rgfa	薅
renp	薆
rhx	薆
rmip	薇
rad	薈
raqd	薈
rzas	薉
rufr	薊
rbib	薋
rrib	薋
rwab	薌
rwdb	薌
rxi	薌
retl	薍
rfnq	薎
rldh	薏
rhyp	薐
rhy	薐
reqe	薑
rjm	薒
rzcm	薒
rweu	薓
rwoo	薔
rlbf	薕
rlq	薕
rqow	薖
royk	薗
rybw	薘
ryw	薘
rvdv	薙
rddm	薚
rde	薚
rpbg	薛
rpbl	薛
rcol	薜
rpj	薜
rnli	薝
rvo	薝
rdx	薞
rae	薟
raob	薟
roa	薟
rftb	薠
rft	薠
rmd	薡
rnds	薢
rydu	薣
ryou	薣
rdre	薤
kf	薦
rlkf	薦
rlhf	薧
rlnf	薧
rlof	薧
rfnf	薨
rblp	薩
rbls	薩
rbws	薩
rli	薪
rltk	薪
rgqf	薫
rbpt	薬
rpdt	薬
rrn	薬
rfh	薯
rfyd	薯
rgqf	薰
raa	薱
rfa	薱
rfea	薱
rnsb	薲
ryow	薳
rnht	薴
rnt	薴
ryya	薵
reqq	薶
ruqq	薶
rur	薷
rutr	薷
rwcs	薸
rte	薹
ryop	薹
rwh	薺
rwr	薺
rwst	薻
rcyw	薽
rrx	薾
rfvz	薿
rfff	藀
rlht	藁
rlnt	藁
rlot	藁
rqt	藁
rrub	藂
rruk	藂
rruq	藂
rlhi	藃
rlni	藃
rloi	藃
rqi	藃
rkbs	藄
rfir	藅
rnjh	藆
rea	藇
rmjd	藈
rmk	藈
rlrd	藉
xd	藉
reev	藋
rnhc	藌
rrf	藍
rrvf	藍
reff	藎
raqr	藏
rrv	藏
reqr	藐
ruqr	藐
rnfp	藑
rnnp	藑
rnop	藑
rhdb	藒
rhdl	藒
rhd	藒
rlqu	藕
rrub	藖
rjcw	藗
rvsw	藗
rzqh	藘
rlqu	藙
rjm	藚
ryfb	藚
rym	藚
rngf	藛
rhdw	藜
rjzt	藝
rt	藝
rybt	藝
rykt	藝
ryrt	藝
ryzt	藝
rzl	藝
rzz	藝
rloo	藞
rqqq	藟
rlnw	藡
rxw	藡
rmip	藢
rfuf	藣
rfu	藣
rubw	藤
rpdt	藥
rrn	藥
rwpt	藥
rlth	藦
rsep	藧
rseu	藧
rse	藧
rlbf	藨
rwmq	藩
rmgp	藪
rwcj	藫
rwx	藫
rbcb	藬
rbq	藬
rnbq	藭
rnrq	藭
rtvf	藮
rcah	藯
rcrh	藯
rddr	藰
roar	藰
rlbu	藱
rlbv	藱
rtfo	藲
rsdf	藴
rsof	藴
rlhz	藶
rih	藷
riyd	藷
reqd	藸
reqh	藸
ridb	藹
ridl	藹
rid	藹
rmv	藺
rwlt	藻
rwot	藻
rnfh	藼
rnhh	藼
rll	藽
rltr	藽
rjcb	藾
rvsb	藾
ruv	藿
rjfg	蘀
rjfy	蘀
rkoo	蘁
rtoe	蘁
rtol	蘁
rhht	蘂
rzzt	蘃
rok	蘄
rook	蘄
rmii	蘅
rmit	蘅
rfp	蘆
rzqf	蘆
rdb	蘇
rufh	蘇
rhrb	蘈
rhrt	蘈
rfnr	蘉
rfnu	蘉
rsdf	蘊
rsof	蘊
rpj	蘋
rzsb	蘋
rzst	蘋
rmis	蘌
rgqd	蘍
rgqf	蘍
rfrb	蘏
rfrt	蘏
riep	蘐
rieu	蘐
rie	蘐
rlto	蘑
rhuf	蘓
rspw	蘕
rabt	蘖
rpbt	蘖
rcot	蘗
rpt	蘗
rln	蘘
rlok	蘘
rfve	蘙
rufh	蘚
rkbu	蘛
rklu	蘛
rkru	蘛
rktu	蘛
rrcm	蘜
raoi	蘝
roi	蘝
raop	蘞
rap	蘞
rop	蘞
rbeh	蘟
rgwo	蘠
rmbg	蘡
rsg	蘡
ral	蘢
rlul	蘢
rkak	蘣
rrek	蘣
rrqk	蘣
rpdf	蘤
raom	蘥
ruoo	蘦
rzew	蘧
rzw	蘧
ruus	蘨
ruws	蘨
rvos	蘩
rvs	蘩
rlbm	蘪
rwrf	蘫
rpbn	蘬
bse	蘭
rmcs	蘭
rmjs	蘭
rmn	蘭
rflr	蘮
rwdf	蘯
rwef	蘯
rmab	蘱
rmat	蘱
rqqy	蘲
rkyy	蘳
rrey	蘳
rfed	蘴
rffd	蘴
rfid	蘴
rrld	蘵
rhgu	蘶
rhgv	蘶
revf	蘸
rhlk	蘹
rlv	蘺
rlxv	蘺
rwuv	蘺
rcrs	蘻
rcus	蘻
rlts	蘼
rqqt	蘽
rylk	蘾
rfc	蘿
rfsv	蘿
rwre	虀
reap	虁
rtmp	虁
rtzp	虁
rzpp	虁
rul	虂
ruoo	虂
rwbe	虃
rqqs	虆
rqrv	虇
rqr	虇
rooo	虈
rtmo	虈
rtoo	虈
reof	虉
rist	虊
rlft	虊
rsit	虊
rsnd	虋
rbx	虌
rsnx	虌
zl	虍
zrl	虎
zrz	虎
zee	虐
lzr	虒
kzr	虓
zwx	虔
ppa	處
prz	處
zpr	處
zv	處
zhj	虖
zke	虗
zpo	虗
zde	虘
zme	虘
zhp	虙
zfe	虚
zfe	虛
zdx	虜
zdy	虜
zqd	虜
zrnm	虝
zoed	虞
zogn	虞
zokb	虞
zokd	虞
okk	號
okzr	號
ol	號
zfeb	虡
eazr	虢
uazr	虢
eaxr	虣
wzr	虣
zrzr	虤
zraq	虥
zrk	虥
rkk	虧
zk	虧
zvrk	虧
zttm	虨
sdsr	虩
spdr	虩
zrpf	虪
ca	虫
cll	虬
cdp	虭
crl	虮
crz	虮
cgi	虯
cti	虰
lca	虱
zca	虱
cna	虳
cgl	虴
cal	虵
cuj	虶
cgj	虷
czj	虸
cie	虹
erc	虺
cfl	虻
cvz	虼
oca	虽
uca	虽
cfy	蚄
clp	蚅
ccl	蚆
ccn	蚇
wca	蚉
cwx	蚊
cnb	蚋
cfj	蚌
cbl	蚍
cdo	蚎
cue	蚏
cnb	蚐
cnr	蚐
cju	蚑
cnae	蚒
cnl	蚒
cqi	蚓
cxx	蚔
edc	蚕
gnc	蚕
pdc	蚕
crr	蚖
cjn	蚗
cak	蚘
cay	蚙
cki	蚚
cci	蚛
ccj	蚛
cxp	蚜
cyp	蚜
cml	蚝
ctn	蚞
cke	蚟
bdc	蚠
cbd	蚡
clr	蚢
cbu	蚣
uac	蚤
ubc	蚤
cbx	蚥
cnr	蚦
cue	蚦
cbr	蚧
cqn	蚨
eca	蚩
eec	蚩
cdj	蚪
cpax	蚮
cke	蚯
cpo	蚯
ciq	蚰
cvf	蚱
cpj	蚲
cxe	蚳
cwd	蚴
cto	蚵
cgo	蚶
cff	蚷
cka	蚸
cpa	蚹
cny	蚺
tlc	蚻
cno	蚼
cbe	蚽
cpx	蚾
clw	蚿
cak	蛀
cdo	蛁
caxx	蛂
cax	蛂
cenb	蛃
cen	蛃
cjo	蛄
czo	蛅
cme	蛆
cnf	蛇
csn	蛈
cap	蛉
cat	蛉
fbc	蛋
yzc	蛋
cga	蛌
cfo	蛐
cror	蛐
cus	蛑
jaqc	蛓
coo	蛔
cxe	蛕
cxu	蛕
cakm	蛖
pbc	蛗
cbh	蛘
cyy	蛙
cdr	蛚
csb	蛛
css	蛛
cpe	蛜
cdk	蛝
cgo	蛞
clx	蛟
cee	蛡
cbk	蛢
cyo	蛣
cao	蛤
cen	蛦
cjqb	蛦
ctd	蛨
irac	蛩
izc	蛩
fdc	蛪
hdc	蛪
cnlp	蛫
cnp	蛫
rbc	蛬
cpe	蛭
lfc	蛮
cesi	蛵
csi	蛵
cui	蛵
cuy	蛵
cea	蛶
cua	蛶
cajw	蛷
cna	蛷
csu	蛸
ctj	蛹
ctnq	蛹
cgn	蛺
cbor	蛻
ccj	蛼
cmb	蛽
cix	蛾
cayo	蛿
fnc	蜀
cvfb	蜁
cvyz	蜁
cpf	蜂
fkc	蜃
cfk	蜄
cajq	蜅
cij	蜅
cmr	蜆
jkc	蜇
coed	蜈
cogn	蜈
cokb	蜈
cokd	蜈
cez	蜉
chr	蜊
cadk	蜋
can	蜋
cby	蜌
cat	蜍
cbh	蜍
cou	蜎
pzwc	蜑
cpzw	蜒
ckw	蜓
cbor	蜕
coh	蜖
coo	蜖
cvdo	蜘
ctbu	蜙
rssc	蜚
ccjo	蜛
nhpc	蜜
xc	蜜
kbc	蜝
ckb	蜞
coh	蜠
crd	蜡
czf	蜢
cbkr	蜣
tkc	蜤
ctk	蜥
cam	蜦
cfad	蜧
cjez	蜨
cjz	蜨
czez	蜨
cno	蜩
cnyo	蜩
cni	蜪
cnwu	蜪
cdb	蜫
ckbu	蜬
cwu	蜬
cng	蜭
caqe	蜮
che	蜮
ucc	蜰
uclc	蜰
cpg	蜱
cpqg	蜱
chg	蜲
clhz	蜳
cloz	蜳
clz	蜳
cdnm	蜴
cep	蜴
chi	蜵
chp	蜵
cjj	蜶
cbnl	蜷
cbnp	蜷
cpl	蜷
ruc	蜸
crnb	蜹
cgr	蜺
chu	蜻
cve	蜼
ceb	蜽
cenb	蜽
ctnb	蜽
cqt	蜾
cncp	蜿
ccs	蝀
cjqs	蝀
oca	蝁
cplu	蝂
cuuu	蝃
edec	蝅
gagc	蝅
gngc	蝅
crj	蝆
cyig	蝆
cyzq	蝆
coil	蝇
coql	蝇
chd	蝌
cdup	蝍
cgi	蝍
cdl	蝎
cdnl	蝎
clht	蝏
clnt	蝏
clot	蝏
cdm	蝐
cfbu	蝑
cyzu	蝑
ctoh	蝒
cai	蝓
caur	蝓
cbpd	蝔
xca	蝕
cnee	蝖
cne	蝖
cpdk	蝗
cfdg	蝘
cfm	蝙
cmt	蝚
caqg	蝛
cdmb	蝜
cnmb	蝜
cceq	蝝
ccm	蝞
cqu	蝟
ceoq	蝠
crd	蝡
ctnd	蝡
cta	蝢
ctmb	蝢
cfj	蝣
cfvz	蝣
cbe	蝤
mpc	蝥
cfa	蝦
cofu	蝦
cox	蝦
crc	蝧
racc	蝨
zcc	蝨
zjcc	蝨
zxcc	蝨
cgq	蝩
cdem	蝪
cdvm	蝪
cep	蝪
cho	蝫
cypd	蝫
cxup	蝬
cdez	蝭
cjn	蝭
cvdp	蝮
cvx	蝮
cegu	蝯
cex	蝯
fcc	蝱
chom	蝳
cfu	蝴
cjou	蝴
hfc	蝵
cst	蝶
clbe	蝷
conb	蝸
cqo	蝸
cdf	蝹
cobf	蝹
cpcu	蝺
cjng	蝻
cnj	蝻
cfnd	蝽
cdkw	螁
cab	螂
cadb	螂
cgy	螃
clnf	螃
cpbn	螄
cren	螄
cpmh	螅
cewd	螇
clps	螈
cya	螈
cbue	螉
cbef	螊
cqn	螊
cgiu	螋
cgu	螋
cigu	螋
ec	融
eonc	融
ceot	螎
clbd	螏
cwf	螐
cpmd	螑
jbc	螒
jdjc	螒
cfnh	螓
clzr	螔
cqu	螖
cleo	螗
ced	螘
tcc	螙
uca	螚
uufc	螚
cnfo	螛
cnho	螛
ynec	螜
ynrc	螜
cpqu	螝
cpru	螝
cva	螝
cmf	螞
cndl	螟
wcc	螡
fc	螢
ffnc	螢
rnc	螢
ubnc	螣
wcib	螤
clno	螪
cxo	螪
yfpc	螫
crfd	螬
crod	螬
cla	螭
clxu	螭
cwuu	螭
cfnn	螮
hnpc	螯
yfpc	螯
clb	螰
cac	螱
crsc	螱
cnbp	螲
cnrp	螲
csny	螳
bcsc	螴
bjqc	螴
ccrs	螵
ffcc	螶
lpgc	螷
lpqc	螷
bboc	螸
wic	螸
cck	螹
cqs	螺
cmg	螻
crc	螼
pbcc	螽
cna	螾
cneb	螾
geac	螿
guac	螿
clbj	蟀
clj	蟀
clwj	蟀
oxcc	蟁
cnt	蟂
cdfu	蟃
cmx	蟃
jzc	蟄
ybgc	蟄
yzc	蟄
clrf	蟅
cdv	蟆
crdd	蟆
rddc	蟇
coae	蟈
coh	蟈
coka	蟈
ceem	蟉
cem	蟉
mcc	蟊
cmh	蟋
cboh	蟌
cpa	蟌
cpoh	蟌
chrt	蟍
cldj	蟑
crar	蟒
crdr	蟒
cncq	蟓
cnn	蟓
cqf	蟔
czfn	蟕
ckbk	蟖
jcnc	蟗
vnoc	蟗
cpab	蟘
clad	蟙
ydmc	蟚
cydm	蟛
cyom	蟛
cgi	蟜
cgno	蟜
cgo	蟜
cpdo	蟜
cwft	蟝
bca	蟞
snsc	蟞
cdbs	蟟
cla	蟟
cmq	蟠
cbwf	蟡
cewf	蟡
cwa	蟡
cywf	蟡
cydo	蟢
cyoo	蟢
cwb	蟣
cwwb	蟣
cflb	蟤
colb	蟤
cka	蟥
creb	蟥
cja	蟦
cjrb	蟦
cffd	蟧
lbec	蟨
clbi	蟩
cch	蟪
ccuh	蟪
cjqh	蟪
ccdj	蟫
cxj	蟫
coj	蟬
cooj	蟬
cvf	蟭
cbho	蟮
cbko	蟮
cqer	蟯
cyr	蟯
cyyr	蟯
ceh	蟰
ccc	蟲
ceia	蟳
kbkc	蟴
crok	蟶
csnq	蟷
cso	蟷
eqcc	蟸
ndsc	蟹
cloe	蟺
clom	蟺
cax	蟻
cbki	蟻
cbx	蟻
nca	蟼
rnoc	蟼
cybw	蟽
cyw	蟽
cnli	蟾
cvo	蟾
cruc	蟿
curc	蟿
cbib	蠀
crib	蠀
wabc	蠁
wadc	蠁
xca	蠁
crst	蠂
foua	蠃
fouz	蠃
fuca	蠃
fucz	蠃
coql	蠅
cxl	蠅
enc	蠆
rqnc	蠆
vca	蠆
crqu	蠇
mbac	蠈
cfek	蠉
con	蠉
clpq	蠊
clq	蠊
cfnc	蠋
ccn	蠌
cfyg	蠌
cfy	蠌
cdi	蠍
cdni	蠍
crar	蠎
crdr	蠎
cnds	蠏
cwh	蠐
cfft	蠑
rca	蠒
crnq	蠓
clhq	蠔
clnq	蠔
cloq	蠔
cqv	蠔
cur	蠕
cutr	蠕
crvu	蠖
ceev	蠗
cjav	蠘
cnsb	蠙
rocc	蠚
rxoc	蠚
crfb	蠛
crfv	蠛
txxc	蠜
cqqq	蠝
crd	蠟
csfs	蠟
csl	蠟
csos	蠟
tohc	蠠
ceqc	蠡
fndc	蠢
cfn	蠣
clru	蠣
clv	蠣
becc	蠤
eblc	蠥
epbc	蠥
czqf	蠦
ynlc	蠧
creh	蠨
cih	蠩
ciyd	蠩
aca	蠪
lulc	蠪
eqrc	蠫
uqrc	蠫
cal	蠬
clul	蠬
pfwc	蠭
cfve	蠮
lpgc	蠯
lpqc	蠯
cln	蠰
clok	蠰
cccf	蠱
cfe	蠱
bebc	蠲
yfnc	蠲
cmbg	蠳
csg	蠳
cevo	蠵
edc	蠶
gnc	蠶
kkdc	蠶
pdc	蠶
cmmv	蠷
cre	蠸
crov	蠸
jcnc	蠹
vnlc	蠹
issc	蠻
lfc	蠻
sisc	蠻
cmmu	蠼
svac	蠽
ccwc	蠾
wwec	蠿
wwfc	蠿
wwwc	蠿
pfe	血
fpf	衁
pfda	衂
pfb	衃
pfe	衄
pfb	衅
pfmk	衆
pfpb	衆
pfq	衆
pflk	衇
pfr	衈
pfra	衊
pfrb	衊
pfre	衊
pfrv	衊
etdf	衋
miri	行
mv	行
miwi	衍
miwt	衍
wtv	衍
migi	衎
migt	衎
miui	衎
miut	衎
miri	衏
mirt	衏
mili	衒
milt	衒
atl	術
atn	術
at	術
miai	術
miat	術
mini	衕
mint	衕
miri	衖
mirt	衖
riv	衖
rtv	衖
miyi	街
miyt	街
st	街
miwi	衘
miwt	衘
miwi	衙
miwt	衙
wiv	衙
miji	衚
mijt	衚
miwi	衛
miwt	衛
pee	衛
mibi	衜
mibt	衜
mihi	衜
miht	衜
migi	衝
migt	衝
mt	衝
miwi	衞
miwt	衞
pee	衞
misi	衟
mist	衟
miui	衡
miut	衡
ut	衡
mimi	衢
mimt	衢
lkn	衣
vgj	衦
vuj	衧
hkn	表
vk	表
vua	衩
val	衪
vmp	衫
vqn	衭
lbuk	衮
luk	衮
vbd	衯
ldk	衰
vpu	衱
vrn	衱
vnb	衲
vbu	衳
vkl	衴
vdo	衵
vci	衶
vcj	衶
jck	衷
lck	衷
vkn	衷
vbr	衸
vxx	衹
lxk	衺
lyk	衺
vnr	衻
vue	衻
vju	衼
vke	衽
aylk	衾
vay	衿
vnb	袀
vnr	袀
yok	袁
vjn	袂
cdlk	袃
vgn	袄
vpd	袄
dolk	袈
vnf	袉
vap	袊
vat	袊
paxk	袋
lnk	袌
lnok	袌
vnl	袍
vnol	袍
vwd	袎
vxi	袏
vhp	袐
vdo	袑
vde	袒
vme	袓
vto	袔
vnb	袕
viq	袖
vbm	袗
vva	袘
vpd	袙
vaxx	袚
vax	袚
vxe	袛
vqb	袜
vys	袜
lok	袞
lrok	袞
vsn	袟
lsnk	袠
vny	袡
vbj	袢
vsl	袣
lmk	袤
vlo	袥
vee	袦
veu	袦
vno	袧
vlw	袨
vzo	袩
vyu	袪
vpx	被
luok	袬
tok	袬
vpad	袱
lcck	袲
vdrk	袴
vxk	袴
vpk	袵
vps	袶
vao	袷
vxiz	袸
vtd	袹
vyo	袺
vri	袻
vtnr	袻
vpo	袼
vgo	袽
vsb	袾
vss	袾
vyy	袿
vod	裀
jaqk	裁
jk	裁
dk	裂
drlk	裂
vdk	裉
nlk	裊
vde	裋
vgn	裌
vot	裍
vok	裎
lqk	裏
vou	裐
lgk	裒
lkno	裔
vbbo	裕
vwo	裕
vfk	裖
vts	裗
ajwk	裘
nlk	裘
veo	裙
jklk	裚
lck	裛
lclk	裛
lock	裛
vajq	補
vij	補
vpa	補
gk	裝
gylk	裝
vbor	裞
wslk	裟
eolk	裠
vqe	裡
vq	裡
lemk	裦
vff	裧
vpg	裨
vpqg	裨
vdb	裩
vni	裪
vnwu	裪
vhi	裫
vhp	裫
vybp	裬
vyrp	裬
vyx	裬
vzr	裭
vdd	裮
vno	裯
vnyo	裯
vuuu	裰
vhk	裱
veb	裲
venb	裲
snok	裳
rssk	裴
lrsk	裵
vrss	裶
vbnl	裷
vbnp	裷
vpl	裷
vqt	裸
lqbk	裹
lqtk	裹
vdil	裺
vdql	裺
vxl	裺
fsuk	裻
vdnm	裼
vep	裼
sk	製
snrk	製
vcjo	裾
vdto	裿
vvo	裿
vkb	褀
qtk	褁
vyyp	褂
vzu	褃
vlnn	褅
vdez	褆
vjn	褆
vdp	複
vp	複
vvdp	複
vvx	複
vx	複
vfdd	褉
vhdd	褉
vfm	褊
vst	褋
vnc	褌
lehk	褎
leik	褏
leqk	褏
vdl	褐
vdnl	褐
vegu	褑
vex	褑
leok	褒
lpok	褒
vpot	褓
veoq	褔
vai	褕
vaur	褕
vceq	褖
vfdg	褗
vwj	褘
vwos	褘
vffu	褙
vho	褚
vypd	褚
vmg	褛
vdf	褞
vobf	褞
vdee	褟
vrao	褡
vro	褡
lpqk	褢
lvk	褢
vnbo	褣
vnw	褣
vyok	褤
vfka	褥
vul	褦
vuuf	褦
rflk	褧
zruk	褩
vdkw	褪
vlzr	褫
vuut	褬
lmfk	褭
ffnk	褮
vlrn	褯
njlk	褰
lfwk	褱
vlc	褲
vcw	褳
vla	褵
vlxu	褵
vwuu	褵
veed	褶
vmiz	褷
vmg	褸
vyba	褹
vybz	褹
vyka	褹
vyra	褹
vyrz	褹
vyz	褹
ljzk	褻
ljzx	褻
lybk	褻
lykk	褻
lyrk	褻
lyzk	褻
vcdl	褼
vcdp	褼
calk	褽
crsk	褽
vcrs	褾
vrfd	褿
vrod	褿
vhmb	襀
vqoc	襁
vquc	襁
vudm	襂
vum	襂
vuum	襂
leok	襃
ln	襄
look	襄
vfb	襆
vfed	襆
vvn	襆
vflb	襈
volb	襈
vmu	襉
vdeu	襊
vdru	襊
vjj	襋
vjns	襋
vbqj	襌
voj	襌
vooj	襌
vvt	襍
vmq	襎
vfx	襏
vjqu	襏
vncq	襐
vnn	襐
veia	襑
vbx	襒
vsnp	襒
vyr	襓
vyyr	襓
vgn	襖
vpd	襖
vpnd	襖
vpob	襖
vcn	襗
vfyg	襗
vfy	襗
vad	襘
vaqd	襘
vlt	襙
voot	襙
vbew	襚
vffk	襛
vnk	襛
vrok	襛
vnli	襜
vvo	襜
vae	襝
vaob	襝
voa	襝
colk	襞
plk	襞
vtts	襟
vse	襠
vsnq	襠
vso	襠
vfnc	襡
vloe	襢
vlom	襢
vpmr	襣
vrf	襤
vrvf	襤
vpfb	襥
vpfd	襥
vpv	襥
vur	襦
vutr	襦
vrx	襧
vjm	襩
vyfb	襩
vym	襩
vrfa	襪
vrfb	襪
vrfe	襪
vrfv	襪
vys	襪
vdtd	襫
vjtb	襫
vfuf	襬
vfu	襬
vfyu	襬
vyob	襭
vyot	襭
vdrw	襮
vaa	襯
vll	襯
vltr	襯
val	襱
vlul	襱
akpk	襲
alk	襲
lulk	襲
vbbe	襳
vmcs	襴
vmjs	襴
vmn	襴
vjab	襶
vsrb	襸
vllb	襹
vrnc	襺
vtxh	襻
vryt	襼
vrms	襽
vrm	襽
co	襾
enu	襾
eun	襾
rny	襾
co	西
cgx	要
v	要
cbz	覂
cpaz	覂
cpz	覂
cdj	覃
xj	覃
cgnm	覅
cmip	覆
cmiv	覆
cv	覆
vdp	覆
vx	覆
crcu	覇
urcu	覇
cpdp	覈
crco	覉
crcv	覉
crcf	覊
mrl	見
umr	覌
qamr	規
ql	規
qnmr	規
pmr	覑
mmr	覒
emr	覓
bmr	覔
hpmr	覕
rr	視
rsmr	視
emr	覗
yeor	覗
zomr	覘
snmr	覚
lkmr	覛
rbbr	覜
rmr	覜
rssr	覜
gfmr	覝
mrmr	覞
yhmr	覟
wmr	覡
ffmr	覢
hgmr	覣
zrmr	覤
fbmr	覥
rorr	覥
amr	覦
aurr	覦
rmr	覧
rvar	覧
rver	覧
vl	覧
hmr	覩
ydmr	覩
ypdr	覩
ll	親
ltmr	親
ltn	親
gmr	覫
lnfr	覫
edmr	覬
ndlr	覭
ffnr	覮
jmr	覯
jnyr	覯
zmmr	覰
ckmr	覱
rcmr	覲
vmr	観
wvmr	観
mumr	覵
etnr	覶
zfer	覷
mrmp	覹
snmr	覺
sr	覺
zdmr	覻
rmr	覼
rfmr	覽
rvar	覽
rver	覽
vl	覽
nmqr	覾
jmmr	覿
yfmr	覿
ymmr	覿
rmr	觀
roor	觀
umr	觀
vmr	觀
ne	角
ngi	觓
ndx	觔
ndy	觔
sne	觕
njn	觖
npu	觙
nrn	觙
nga	觚
nde	觛
zfn	觜
nxe	觝
nyy	觟
bnn	觠
npo	觡
fdn	觢
hdn	觢
nbh	解
nds	解
nnlp	觤
nnp	觤
nser	觥
nca	触
nbh	觧
niw	觨
najw	觩
nna	觩
nlj	觪
njcs	觫
nvs	觫
ngr	觬
ndto	觭
nvo	觭
ncew	觮
new	觮
nho	觰
nypd	觰
aqpn	觱
aqvn	觱
kne	觱
nbhs	觲
nbks	觲
yneu	觳
ynnu	觳
nvdm	觴
nvd	觴
nve	觴
nka	觵
nreb	觵
nrtb	觵
noj	觶
nooj	觶
snn	觷
nca	觸
nc	觸
nfnc	觸
fvdn	觺
npdt	觻
nrn	觻
nwpt	觻
nnfp	觼
nnnp	觼
nnop	觼
nrff	觾
nrof	觾
nevo	觿
io	言
iti	訂
ipa	訃
kio	訄
ikl	訅
ikx	訅
ikz	訅
igi	訆
nio	訇
ijj	計
ira	訊
izj	訊
izx	訊
ina	訋
ine	訋
iie	訌
iua	訍
iaa	討
iuj	訏
igj	訐
ial	訑
ida	訒
idn	訒
isi	訓
iei	訕
ivz	訖
igl	託
jgl	託
ifl	記
ika	訙
iza	訙
izx	訙
ipf	訛
ibd	訜
ixp	訝
iyp	訝
ign	訞
ipd	訞
ibu	訟
iqi	訠
iay	訡
iki	訢
ijn	訣
inb	訥
ikl	訦
inr	訦
iak	訧
ize	訨
ixu	訩
ify	訪
iha	訫
isp	訬
iru	設
iel	訰
iwj	許
ici	訲
icj	訲
ika	訴
ifo	訵
ito	訶
ihn	訸
iat	訹
ibm	診
iak	註
iez	証
ino	訽
zfi	訾
izf	訿
izo	詀
ijo	詁
ipa	詂
ilw	詃
isn	詄
iap	詅
iat	詅
ixe	詆
fio	詈
igu	詉
ibj	詊
ior	詋
igo	詌
isl	詍
iff	詎
iwd	詏
ivf	詐
inf	詑
iuo	詒
ido	詔
ipj	評
ip	評
ipx	詖
ino	詗
iee	詘
ieu	詘
iaxx	詙
iax	詙
ide	詚
ime	詛
int	詝
ieo	詞
iyeo	詞
iun	詠
iee	詡
ind	詢
ifd	詣
ibls	詤
ifs	詤
iao	詥
iaxi	試
iiv	試
iv	試
jio	詧
ilx	詨
iya	詩
idk	詪
igv	詫
ing	詫
ifo	詬
inlp	詭
inp	詭
ibk	詮
ipm	詯
iyo	詰
igo	話
ilh	該
il	該
ibh	詳
ixe	詴
ixu	詴
isr	詵
iyyy	詶
ineo	詷
imn	詸
nlbi	詹
nlri	詹
vo	詹
ico	詺
ipo	詻
ilf	詼
ixf	詼
igg	詽
ikj	詽
inxu	詾
iyy	詿
irj	誀
ibk	誁
ira	誂
irbb	誂
icc	誃
iln	誄
isb	誅
iss	誅
ifk	誆
idrk	誇
ixk	誇
ipe	誈
iflh	誋
iyh	誌
ibn	認
idah	認
ijcs	誎
ivs	誎
iadk	誏
ian	誏
iix	誐
iqk	誑
ian	誒
iuvd	誒
jki	誓
oi	誓
ikw	誔
ipzw	誕
iw	誕
ijnz	誖
ihr	誘
iesi	誙
isi	誙
iui	誙
iuy	誙
isu	誚
ienu	誛
irx	誛
ihx	誜
iubp	誜
iurp	誜
iayo	誝
iwo	語
iypz	誟
iaqn	誠
iaqy	誠
iay	誠
iaqr	誡
irv	誡
imr	誢
iwe	誣
id	誤
ioed	誤
iogn	誤
iokd	誤
iso	誥
itj	誦
itnq	誦
iajq	誧
iij	誧
im	誨
ivom	誨
iio	誩
ibor	說
ir	說
ifk	誫
ibor	説
ir	説
idd	誯
ive	誰
ijez	誱
ijz	誱
iqt	課
icee	誳
iceu	誳
inrs	誴
ins	誴
ixxu	誵
ixx	誵
ijj	誶
inbf	誷
iqlw	誸
irss	誹
iln	誺
iwd	誻
inm	誼
igr	誽
mio	誾
ino	調
inyo	調
ipg	諀
ipqg	諀
iuuu	諁
ine	諂
ing	諂
itt	諃
iloz	諄
ilz	諄
kbi	諅
ikb	諆
iff	談
ige	諈
igjy	諈
ihg	諉
inm	諊
ihu	請
ics	諌
ijqs	諌
iee	諍
ine	諍
ird	諎
iru	諏
posi	諐
ieqa	諑
ilos	諒
ils	諒
iaqq	諓
ikx	諓
ifsu	諔
izr	諕
iam	論
ibf	論
iayh	諗
ihk	諘
ixd	諙
igb	諛
ist	諜
ifbu	諝
iyzu	諝
ifm	諞
idez	諟
ijn	諟
inee	諠
ine	諠
iakf	諡
ibkf	諡
inc	諢
ionb	諣
iqo	諣
iok	諤
iook	諤
igq	諥
ilnn	諦
ibpd	諧
ieoq	諨
ibee	諩
ibe	諩
ibo	諩
ilht	諪
ilnt	諪
ilot	諪
itv	諪
ics	諫
ijqs	諫
haki	諬
iai	諭
iaur	諭
ibio	諮
irio	諮
idi	諯
ietr	諯
iqh	諰
iwj	諱
iwos	諱
icy	諲
ild	諳
iaqo	諴
iko	諴
ijng	諵
ikbl	諶
iklb	諶
iklr	諶
ikl	諶
ikrl	諶
icv	諷
irc	諷
iho	諸
iypd	諸
xg	諸
idem	諹
idvm	諹
iep	諹
ilpm	諺
iwlm	諺
ipdk	諻
iegu	諼
iex	諼
irc	諽
iro	諾
irxo	諾
ior	諿
igt	謀
idl	謁
idnl	謁
iqu	謂
bni	謄
ubni	謄
inee	謅
ifee	謆
nji	謇
drbi	謈
ipqu	謉
ipru	謉
iva	謉
irfs	謊
is	謊
icst	謋
ict	謋
itoo	謌
ffni	謍
imw	謎
igiu	謏
igu	謏
ihpf	謐
iewd	謑
iado	謒
ijb	謓
ijmb	謓
ize	謔
ilzr	謕
iqbp	謖
iqrp	謖
igy	謗
ilnf	謗
icl	謘
ibef	謙
iqn	謙
ibef	謚
iye	謚
ije	講
ijj	講
ijny	講
iy	講
ilps	謜
iya	謜
isa	謝
ilho	謞
ilno	謞
iloo	謞
iqo	謞
ieg	謟
iewu	謠
iuu	謠
iuwu	謠
ivu	謢
iurk	謣
icrs	謤
iboh	謥
ipa	謥
ipoh	謥
ycri	謦
yio	謦
ila	謧
ilxu	謧
iwuu	謧
idv	謨
irdd	謨
rddi	謩
ilno	謪
ixo	謪
ilno	謫
ixo	謫
ieem	謬
iem	謬
ibd	謭
ibed	謭
ihmb	謮
izde	謯
izm	謯
icw	謰
img	謱
ium	謲
iuum	謲
ifoo	謳
ifx	謳
ioa	謴
iomb	謴
ioxb	謴
ieed	謵
ilrf	謶
hnpi	謷
yfpi	謷
ihnp	謸
iyfp	謸
irc	謹
jzi	謺
ybgi	謺
yzi	謺
ihcc	謻
izh	謼
qoci	謽
quci	謽
idfu	謾
imx	謾
ijdu	謿
iju	謿
iirp	譀
itrp	譀
iaj	譁
ipfj	譁
irjq	譁
irrj	譁
irrq	譁
ibqj	譂
ioj	譂
iooj	譂
izfe	譃
idaz	譅
iydo	譆
iyoo	譆
idh	譇
idyd	譇
ilhp	譈
ilop	譈
ilzp	譈
ijd	證
iyr	譊
iyyr	譊
imu	譋
ibwf	譌
iewf	譌
lpvi	譍
imno	譎
irl	譏
irz	譏
iwb	譏
iwwb	譏
ibea	譐
igi	譑
igno	譑
igo	譑
ipdo	譑
imq	譒
ich	譓
icuh	譓
ijqh	譓
iflb	譔
iolb	譔
iek	譕
igl	譕
ivff	譕
ikkd	譖
iro	譗
izao	譗
ilad	識
iob	識
ivf	譙
icdj	譚
ixj	譚
ibd	譜
ibed	譜
ibod	譜
ixl	譝
ilt	譟
ioot	譟
iloe	譠
ilom	譠
isnq	譡
iso	譡
ibew	譢
iae	譣
iaob	譣
ioa	譣
ipdp	譤
pdfi	譥
nio	警
rnoi	警
ilpq	譧
ilq	譧
iffk	譨
ink	譨
irok	譨
ildh	譩
irdb	譪
irdl	譪
ird	譪
inli	譫
ivo	譫
coli	譬
pio	譬
pi	譬
igyu	譭
iad	譮
iaqd	譮
icn	譯
ifyg	譯
ify	譯
ig	譯
iuq	譯
iax	議
ibki	議
ibx	議
bhii	譱
icew	譴
it	譴
iaa	譵
ifa	譵
ifea	譵
irvu	護
iu	護
jfp	護
rivu	護
ifa	譸
iyya	譸
ilhq	譹
ilnq	譹
iloq	譹
ifvz	譺
mbmi	譻
sio	譻
rfi	譼
rpvi	譼
rvai	譼
rvei	譼
eio	譽
sebi	譽
ibee	譾
iffh	譿
ib	讀
ijm	讀
ijyb	讀
ijyd	讀
ixbd	讀
iyfb	讀
iym	讀
iynr	讀
ilnw	讁
ixw	讁
infp	讂
innp	讂
iqab	讃
iqnb	讃
iqqq	讄
inmq	讅
miwi	讆
imdg	讇
imng	讇
ilhz	讈
issp	變
lfp	變
lfu	變
sisp	變
aio	讋
luli	讋
irff	讌
irof	讌
ieoe	讍
ikoo	讍
ioe	讍
itol	讍
viv	讎
vvi	讐
iaom	讑
ieb	讒
incb	讒
inoa	讒
inoe	讒
ife	讓
ik	讓
iln	讓
ilok	讓
ibeh	讔
imcs	讕
imjs	讕
imn	讕
ibbe	讖
igj	讖
ievo	讗
irrr	讘
ire	讙
irov	讙
iq	讚
isrb	讚
iryt	讛
irz	讛
oo	讛
isnf	讜
isnr	讜
ioop	讝
iox	讝
inad	讞
ized	讞
ijmi	讟
iyfi	讟
iymi	讟
bbo	谷
wo	谷
bbou	谹
wxu	谹
bbox	谺
bboy	谺
wxp	谺
wyp	谺
bboq	谻
bboz	谻
wzq	谻
bbob	谼
wrb	谼
bboo	谽
wayo	谽
bboi	谾
wbri	谾
wnbi	谾
wnri	谾
ewdo	谿
ewdw	谿
bbod	豀
wewd	豀
nfoo	豁
nfow	豁
nhoo	豁
nhow	豁
bbom	豂
weem	豂
wem	豂
bbop	豃
wirp	豃
wtrp	豃
bbob	豄
bbom	豄
wyfb	豄
wym	豄
bboa	豅
bbol	豅
wal	豅
wlul	豅
de	豆
die	豇
ede	豈
efl	豈
dju	豉
fde	豊
rord	豊
jde	豋
dncp	豌
dpg	豍
dpqg	豍
rud	豎
rul	豎
dbef	豏
dqn	豏
fde	豐
fd	豐
ffed	豐
fifd	豐
iffd	豐
fdbp	豑
fdt	豑
rorp	豑
rort	豑
fddf	豓
ffef	豓
fdc	豔
fdyf	豔
ffec	豔
ffef	豔
fifc	豔
fiff	豔
fnc	豔
iffc	豔
ifff	豔
rorc	豔
rorf	豔
eqn	豕
eqa	豖
eqx	豖
ereq	豗
eqe	豘
ueq	豚
eqru	豛
eqk	豜
eqcl	豝
eqc	豝
eqno	豞
eqfz	豟
eqm	豠
ncq	象
nn	象
bneq	豢
eqbg	豣
eqbk	豣
eqpg	豣
eqdk	豤
eqlh	豥
zeq	豦
zn	豦
eqaq	豧
eqi	豧
eqxn	豨
eqeq	豩
lhnq	豪
lneq	豪
lnq	豪
lonq	豪
lqv	豪
uncq	豫
unn	豫
eqh	豬
eqyd	豬
qho	豬
qypd	豬
eqou	豭
eqo	豭
eqed	豯
yneu	豰
ynqu	豰
ynru	豰
eqdf	豱
eqof	豱
eqls	豲
eqy	豲
eqee	豳
eqeu	豳
eqiu	豳
eqlo	豴
eqx	豴
eqmz	豵
eqjb	豶
eqj	豶
eqyd	豷
eqp	豸
uqp	豸
eqna	豹
uqna	豹
equ	豺
uqu	豺
eqg	豻
uqg	豻
eqb	豼
uqb	豼
eqnb	豽
uqnb	豽
eqbe	豾
uqbe	豾
eqno	豿
uqno	豿
eqee	貀
eqeu	貀
uqee	貀
uqeu	貀
eqnb	貁
uqnb	貁
eqdo	貂
gsdo	貂
uqdo	貂
eqpd	貃
uqpd	貃
eqe	貄
uqe	貄
eqpt	貅
uqpt	貅
eqee	貆
uqee	貆
eqz	貈
uqz	貈
eqpo	貉
uqpo	貉
eqtd	貊
uqtd	貊
eqgr	貌
eqpr	貌
erv	貌
pdr	貌
uqgr	貌
uqpr	貌
eqq	貍
uqq	貍
eqgr	貎
uqgr	貎
eqpg	貏
uqpg	貏
eqar	貐
eqa	貐
uqar	貐
uqa	貐
eqou	貑
eqo	貑
uqou	貑
uqo	貑
eqd	貒
eqer	貒
uqd	貒
uqer	貒
eqrq	貓
qrq	貓
uqrq	貓
eqpb	貔
uqpb	貔
eqed	貕
uqed	貕
eqbf	貖
eqy	貖
uqbf	貖
uqy	貖
eqmg	貗
uqmg	貗
edv	貘
eqrd	貘
qrdd	貘
uqrd	貘
eqfo	貙
eqfx	貙
uqfo	貙
uqfx	貙
eqoj	貚
eqo	貚
uqoj	貚
uqo	貚
eqrv	貛
eqr	貛
uqrv	貛
uqr	貛
eqmu	貜
uqmu	貜
mba	貝
zmb	貞
umb	貟
dmb	負
nmb	負
mbu	財
imb	貢
axmb	貣
mba	貤
mblr	貥
mbrr	貦
bdmb	貧
bmv	貧
pb	貨
pfmb	貨
mblu	販
muv	販
am	貪
aymb	貪
oa	貫
ommb	貫
oxmb	貫
hmb	責
kmb	貭
eaxb	貮
mbnt	貯
smb	貰
mbp	貱
zfmb	貲
axrb	貳
axr	貳
eaxr	貳
cemb	貴
qa	貴
udmb	貵
mbbz	貶
mbpz	貶
fmb	買
ma	買
ybd	買
ax	貸
paxb	貸
mbs	貹
mbor	貺
vmb	費
mbzo	貼
mov	貼
mbuo	貽
mbxe	貾
ddmb	貿
dg	貿
omb	貿
domb	賀
jav	賁
ja	賁
jrmb	賁
mbpo	賂
pkmb	賃
mbxu	賄
mbx	賄
mblh	賅
bb	資
bimb	資
rimb	資
cmb	賈
mbpf	賉
mbaj	賊
mbax	賊
mjv	賊
lhmb	賌
mbly	賍
mbmb	賏
sa	賏
mbh	賐
mbup	賐
mbfk	賑
mbab	賒
mbas	賒
mbbb	賒
mbbs	賒
nbpb	賓
nbv	賓
ncmb	賓
nkeb	賓
npob	賓
nsmb	賓
ncmb	賔
nsmb	賔
mbaw	賕
mbn	賕
mbat	賖
mbbh	賖
mbcc	賗
mbno	賙
mbn	賙
gmb	賚
lmb	賚
qaqb	賛
qnqb	賛
mbdm	賜
mbe	賜
mbnt	賝
mbn	賝
kt	賞
snob	賞
mbfb	賟
mbrb	賟
mblo	賠
lebb	賡
lenb	賡
rbv	賢
rumb	賢
jma	賣
jybd	賣
xbd	賣
yfmb	賣
yma	賣
ynr	賣
mbaq	賤
mbk	賤
mbjj	賥
mbez	賦
mbw	賦
mbff	賧
nrsb	賨
nsmb	賨
mbns	賩
kb	質
kkmb	質
kmb	質
xmb	質
jbbb	賫
jnmb	賫
mbek	賬
mbh	賭
mbyd	賭
efmb	賮
mbnz	賯
mbfd	賰
mbnc	賱
potb	賲
mbjo	賳
jcsb	賴
vb	賴
vsdb	賴
vsnb	賴
mbdm	賵
mbao	賶
joob	賷
ubnb	賸
mbbf	賹
mby	賹
mbbf	賺
mbq	賺
mbaa	賻
mbia	賻
mbjy	購
mbj	購
mbnu	購
nb	賽
njmb	賽
rhmb	賾
fvdb	贀
mbum	贂
mbch	贃
jzmb	贄
ybgb	贄
yzmb	贄
hnpb	贅
yfpb	贅
mbad	贆
weab	贇
wwmb	贇
mbbd	贈
mbb	贈
mbcj	贉
mbx	贉
kz	贊
srsb	贊
lpvb	贋
mbni	贍
mbv	贍
foua	贏
fouz	贏
fuma	贏
fumz	贏
xv	贏
mbef	贐
ldjb	贑
rchb	贒
mbar	贓
mbly	贓
mbrr	贓
mrv	贓
mbmb	贔
mbs	贔
dapb	贕
dapm	贕
eppb	贕
eppm	贕
mbjd	贖
mbxd	贖
mbyb	贖
mbym	贖
lpnb	贗
zrzb	贙
mba	贚
mbll	贚
ldjb	贛
mbrr	贜
yfa	赤
yfi	赥
yfp	赦
yfpu	赧
yfc	赨
yfdc	赩
yfdl	赩
yfnc	赩
yfnl	赩
yfyf	赫
yfzb	赬
yfh	赭
yfyd	赭
yfou	赮
yfo	赮
yflo	赯
yzn	走
ybn	赱
yzn	赱
yzd	赲
yzg	赳
yzp	赴
yzg	赶
yl	起
yzfl	起
yzol	起
yze	赸
yznb	赹
yznr	赹
yzay	赺
yzs	赻
yzi	赼
yzj	赽
yzk	赾
yzx	赿
yzj	趀
ym	趁
yzbm	趁
yzns	趁
yzns	趂
yzvs	趂
yzsn	趃
yzm	趄
yo	超
yzdo	超
yzx	趆
yzl	趇
yzzo	趈
yzee	趉
yzeu	趉
uv	越
yzaf	越
yzai	越
yzap	越
yzne	趋
yzyo	趌
yzcc	趍
yzsb	趎
yzss	趎
yzgo	趏
yzee	趐
yzbi	趑
yzri	趑
yzrb	趒
yzr	趒
yzrt	趓
yzdr	趔
yg	趕
yzdg	趕
yzg	趕
yzby	趖
yzoz	趗
yzcm	趘
yzsu	趙
yzx	趙
yzjs	趚
yzvs	趚
yza	趛
yznm	趜
yzah	趝
yzso	趟
yzq	趠
yzzj	趠
yzv	趡
yzcw	趢
yzew	趢
ku	趣
yzru	趣
yzno	趤
yzbe	趥
yzbo	趦
yzro	趦
yzdz	趧
yzj	趧
yzne	趨
zc	趨
yzqb	趩
yzk	趪
yzrb	趪
yzgo	趫
yzg	趫
yzyr	趬
yzvf	趭
yzlt	趮
yzot	趮
yzev	趯
yzsb	趲
ozn	足
ozb	趴
ozna	趵
ozu	趶
ozvz	趷
ozj	趹
ozqn	趺
ozay	趻
ozk	趼
ozf	趽
ozz	趾
ozpu	趿
ozrn	趿
ozu	跀
ozcl	跁
ozc	跁
ozju	跂
ozka	跅
ozuo	跆
ozs	跇
ozbm	跈
ozap	跉
ozat	跉
ozqb	跊
ozys	跊
ozau	跋
ozax	跋
oza	跋
ozsn	跌
oz	跌
ozjo	跍
oznf	跎
ozdo	跏
ozzf	跐
on	跑
oznl	跑
ozn	跑
ozto	跒
ozak	跓
ozno	跔
ozzo	跕
ozlo	跖
ozpa	跗
ozb	跘
ozm	跙
ozm	跚
ozne	跚
oznr	跚
ozp	跛
ozcf	跜
of	距
ozff	距
ozdk	跟
qz	跟
oze	跠
ozjb	跠
if	跡
lfw	跡
ofv	跡
ozlf	跡
ozcc	跢
ozsr	跣
ozlx	跤
ozsb	跦
ozss	跦
ozbk	跧
ozdk	跨
ozx	跨
ozix	跩
ozi	跩
ozqx	跩
oznp	跪
iraz	跫
izoz	跫
ozyy	跬
ozps	跭
ozp	跮
lo	路
ozpo	路
ozbk	跰
ozya	跱
ozao	跲
ozrb	跳
ozr	跳
ozc	跴
ozrt	跺
ozco	跼
ozoo	跼
ozfh	跽
ozoh	跽
pipz	跾
ozyz	跿
ozoz	踀
ozei	踁
ozsi	踁
ozui	踁
ozrl	踂
ozsu	踃
ozzs	踄
jkoz	踅
tkoz	踅
ozh	踆
ozup	踆
ozvm	踇
ozjs	踈
ozvs	踈
ozak	踉
oza	踉
oztq	踊
ozt	踊
ozyp	踋
ozyz	踍
ozwd	踏
ozaf	踐
ozaq	踐
ozk	踐
ozkb	踑
ozhg	踒
ozv	踓
ozq	踔
ozzj	踔
ozjz	踕
ozzz	踕
ozrd	踖
ozah	踗
oznm	踘
ozru	踙
ozam	踚
ozqu	踛
ozyy	踛
ozy	踛
ozyp	踜
ozy	踜
ozqt	踝
ozco	踞
ozvo	踟
oznp	踠
ozbl	踡
ozbp	踡
ozp	踡
ozdm	踢
oze	踢
ozlo	踣
ozjj	踤
ozlg	踥
ozdo	踦
ozv	踦
ozfu	踧
ozbz	踨
ozet	踩
ozm	踩
ozns	踪
ozbe	踫
ozbo	踫
ozb	踫
ozlo	踮
ozar	踰
oza	踰
ozlu	踱
ozkm	踲
ozfd	踳
oztd	踴
ozgq	踵
ozdz	踶
ozj	踶
ozkb	踸
ozkl	踸
ozkr	踸
ozk	踸
ozd	踹
ozer	踹
ozob	踻
ozqo	踻
ozdm	踼
oze	踼
ozpu	踽
ozeq	踾
ozhf	踿
ozst	蹀
ozfm	蹁
ozmt	蹂
ozro	蹃
ozln	蹄
ozte	蹅
ozdw	蹆
njoz	蹇
og	蹈
ozeg	蹈
ozbi	蹉
ozed	蹊
ozde	蹋
ozao	蹌
ozck	蹍
ozjb	蹎
ozlr	蹏
ozbu	蹐
ozfu	蹐
ozru	蹐
ozwu	蹐
ozdq	蹓
ozoq	蹓
ckoz	蹔
ozqq	蹕
ozq	蹕
ozfg	蹖
ozlb	蹗
ozem	蹘
aqpz	蹙
ozso	蹚
ozsy	蹚
ozfn	蹛
oznd	蹜
ozmz	蹝
ozfb	蹞
ozft	蹞
ozhb	蹟
ozlf	蹠
ozga	蹡
ozlo	蹢
ozx	蹢
ozrb	蹣
ozmz	蹤
ozns	蹤
ozcw	蹥
ozeu	蹦
ozrd	蹧
ozjf	蹨
oznf	蹨
ozuf	蹨
boz	蹩
snsz	蹩
ozcb	蹪
ozq	蹪
ozmo	蹫
ozjd	蹬
ozbd	蹭
ozb	蹭
ozmq	蹯
ozla	蹰
ozba	蹲
ozf	蹳
ozju	蹳
ozg	蹴
ozlk	蹴
goz	蹵
lhsz	蹵
losz	蹵
lsaz	蹵
ozli	蹶
lbez	蹷
ozms	蹸
ozqr	蹺
ozyr	蹺
ozgo	蹻
ozg	蹻
ozfb	蹼
ozfd	蹼
ozv	蹼
ozlt	躁
ozot	躁
ozdw	躂
ozyw	躂
ozcl	躃
ozp	躃
colz	躄
poz	躄
ozfc	躅
ozzq	躆
ozz	躆
ozrd	躇
ozrh	躇
ozpp	躈
rqnz	躉
ozfa	躊
ozya	躊
ozwh	躋
ozwr	躋
ozvs	躌
ovv	躍
ozev	躍
ozgn	躍
ozpd	躍
ozr	躎
ozss	躐
ozs	躐
ozbb	躑
ozgb	躑
ozpt	躒
ozr	躒
ozwt	躒
ozkb	躓
ozly	躔
ozla	躕
ozwe	躖
ozwf	躖
ozwi	躖
ozwl	躖
miwz	躗
oza	躘
ozll	躘
ozmv	躙
ozcw	躚
ozgw	躚
ozms	躝
ozm	躝
ozfu	躞
oziu	躞
ozlk	躟
ozl	躟
rpbz	躠
ozrr	躡
ozru	躡
ozme	躢
ozmv	躣
ozrd	躤
ozns	躥
ozsb	躦
ozlb	躧
ozl	躧
ozbp	躨
ozhp	躨
ozmu	躩
ozrv	躪
sx	身
sqk	躬
sqy	躬
skl	躭
snr	躭
sfx	躯
ste	躰
srt	躱
srt	躲
sopo	躳
sov	躳
sadk	躴
san	躴
sqt	躶
shg	躷
sdto	躸
svo	躸
snm	躹
ssno	躺
sfdg	躽
slew	躿
sfoo	軀
sfx	軀
smg	軁
sffd	軂
sbqj	軃
soj	軃
sooj	軃
sfd	軆
srod	軆
snka	軉
snkb	軉
cj	車
cll	軋
ckl	軌
ckx	軌
ncj	軍
cer	軏
cdn	軑
cgj	軒
cra	軓
cda	軔
cdn	軔
cke	軖
cru	軗
cel	軘
czu	軙
clp	軛
cnb	軜
cxx	軝
cml	軞
cin	軟
cke	軠
cay	軡
chj	軤
cno	軥
cor	軦
cxe	軧
cap	軨
cat	軨
cuo	軩
cwd	軪
cbm	軫
udc	軬
ccn	軮
cpj	軯
cga	軱
cjo	軲
cnl	軳
cnol	軳
cak	軴
cpa	軵
cfz	軶
caxx	軷
cax	軷
ciq	軸
cob	軹
cdo	軺
cto	軻
csn	軼
csi	軽
cui	軽
cuy	軽
caxi	軾
civ	軾
cbk	軿
cri	輀
ctnr	輀
crb	輁
rbc	輂
clx	較
cser	輄
cpo	輅
clh	輆
cbk	輇
cza	輈
jaqc	載
jc	載
cpe	輊
edc	輋
cbbo	輍
cwo	輍
csu	輎
cnrr	輐
ceo	輑
crl	輒
cdcr	輓
cel	輓
cncr	輓
cajq	輔
cij	輔
cesi	輕
csi	輕
cui	輕
cuy	輕
cno	輖
cnyo	輖
cgr	輗
cybp	輘
cyrp	輘
cyx	輘
cru	輙
caqq	輚
ckx	輚
ceb	輛
cenb	輛
ctnb	輛
csq	輜
sc	輝
serc	輝
cnbf	輞
cuuu	輟
cqt	輠
cdto	輢
cvo	輢
cuu	輣
chu	輤
cdb	輥
qaqc	輦
qnqc	輦
cbgg	輧
cbk	輧
cpgg	輧
rc	輩
rssc	輩
cam	輪
cbf	輪
crss	輫
clos	輬
cls	輬
crd	輭
ctnd	輭
cmt	輮
cor	輯
cdem	輰
cdvm	輰
cep	輰
caqo	輱
cko	輱
cdi	輲
cetr	輲
cfnd	輳
cfnn	輳
cfn	輳
ckm	輴
cxm	輴
cdl	輵
cdnl	輵
cbe	輶
cni	輷
cai	輸
caur	輸
cvdp	輹
cvx	輹
ceoq	輻
cq	輻
cdf	輼
cobf	輼
cudq	輽
cuq	輽
ccrk	輾
cb	輿
cgeb	輿
gceb	輿
cdf	轀
cobf	轀
ceg	轁
yncu	轂
yneu	轂
cfnh	轃
cnfo	轄
cnho	轄
cyok	轅
clb	轆
ceem	轇
cem	轇
csqt	轈
ccua	轉
cjqa	轉
cqa	轉
cxa	轉
cffe	轊
chhe	轊
ccw	轋
ctup	轍
ctx	轍
cedo	轎
cgi	轎
cgno	轎
cgnr	轎
cgo	轎
cpdo	轎
cczz	轏
cfb	轐
cfed	轐
cvn	轐
cdbs	轑
cla	轑
cja	轒
cjrb	轒
cmq	轓
cmcs	轔
cmc	轔
crdb	轕
crdl	轕
crd	轕
cwoo	轖
caqh	轗
ckh	轗
cfek	轘
con	轘
cbki	轙
cbx	轙
cruc	轚
curc	轚
caa	轛
cfa	轛
cfea	轛
cur	轜
cutr	轜
ecj	轝
crf	轞
crvf	轞
ccc	轟
cuu	轟
cqqq	轠
csso	轡
scso	轡
cpdt	轢
crn	轢
cwpt	轢
cld	轣
clhz	轣
czqf	轤
crmv	轥
lj	辛
jol	辜
uol	辝
gol	辞
col	辟
pj	辟
pml	辠
llj	辡
jcsl	辢
vsl	辢
ljcs	辣
lvs	辣
enul	辤
eabl	辥
epbl	辥
dba	辦
ldl	辦
ldl	辧
lrl	辨
lxl	辨
lyl	辨
lwl	辬
ej	辭
etnl	辭
gol	辭
lsl	辮
lil	辯
fkn	辰
fka	辱
ffk	農
nkn	農
rork	農
ttfk	農
ttfk	辳
ofk	辴
ooqk	辴
mzn	辵
daw	边
dwn	边
dwn	达
ewn	辿
gwn	迁
gw	迁
uwn	迂
vzw	迄
raw	迅
zjw	迅
zwn	迅
zxw	迅
awn	迆
awn	过
cwn	迉
enw	迊
tnw	迊
kwn	迋
uwn	迌
ewn	迍
enw	迎
fpw	迎
daw	迏
kwn	近
lrw	迒
xwn	迓
ywn	迓
luw	返
wwn	迕
adw	迖
edw	迗
gnw	迗
pdw	迗
bwn	还
iwn	这
wwn	这
zow	迠
cfw	迡
dow	迢
swn	迣
vaw	迤
now	迥
dow	迦
iqiw	迧
iwn	迧
uow	迨
nsw	迩
vsw	迩
iqw	迪
pdw	迫
snw	迭
vfw	迮
cpw	迯
atw	述
nfw	迱
ohw	迴
oow	迴
neow	迵
xuw	迶
xwn	迶
mwn	迷
bkw	迸
lfw	迹
cwn	迺
cwv	迺
ccw	迻
yow	迼
pbw	追
drw	迾
ndw	迿
dkw	退
bedw	送
bgnw	送
gwn	送
gow	适
rbbw	逃
rwn	逃
psw	逄
fow	逅
bew	逆
pnow	逈
srw	选
ajnw	逋
iwn	逋
zofw	逌
suw	逍
ewn	逎
hrw	透
eqw	逐
ajww	逑
nwn	逑
bqiw	递
bqpw	递
twn	递
fjnw	逓
lqnw	逓
atw	途
bhw	途
esiw	逕
siw	逕
uiw	逕
uyw	逕
qfw	逖
dwn	逗
dwv	逗
iwn	這
wwn	這
tnqw	通
twn	通
t	通
qkw	逛
wow	逜
jkw	逝
okw	逞
jcsw	速
vsw	速
vw	速
sow	造
hwn	逡
ubpw	逡
urpw	逡
pfw	逢
cwn	連
wsw	逤
ohw	逥
oow	逥
lwn	逨
djrw	逩
rdw	逪
uuuw	逫
bggw	逬
bkw	逬
pgpw	逬
nbw	逭
eww	逮
ceww	逯
jvzw	逰
nwn	週
nyow	週
jwn	進
vwn	進
qwn	逴
zdjw	逴
ybyw	逵
yryw	逵
ywn	逵
hgw	逶
dnmw	逷
ewn	逷
dcrw	逸
eaw	逸
ncrw	逸
nw	逸
ygkw	逺
ylkw	逺
yokw	逺
yukw	逺
fcw	逻
eoqw	逼
ew	逼
rxow	逽
aurw	逾
awn	逾
denw	逿
ewn	逿
xiuw	遀
kmw	遁
xmw	遁
beqw	遂
bwv	遂
llmw	遃
lpmw	遃
wlmw	遃
dwn	遄
erw	遄
etnw	遄
cbhw	遅
lnnw	遆
qnuw	遇
qw	遇
dezw	遈
jwn	遈
zmbw	遉
fvzw	遊
fwn	遊
ncw	運
twn	運
oorw	遌
own	遌
fmw	遍
mifm	遍
awn	過
qow	過
dnbw	遏
dnlw	遏
dwn	遏
offw	遐
own	遐
pdkw	遑
bew	遒
btmw	道
hwn	道
dwn	達
ybgw	達
ybhw	達
ywn	達
wosw	違
wwn	違
jnyw	遘
jwn	遘
ewuw	遙
uuw	遙
uwuw	遙
uw	遙
giuw	遚
guw	遚
iguw	遚
ddqw	遛
oqw	遛
zesw	遜
zpsw	遜
zsw	遜
fqw	遝
fww	遝
bqiw	遞
bqpw	遞
lqnw	遞
lzrw	遞
twn	遞
clw	遟
rrw	遠
yokw	遠
yw	遠
beuw	遡
deew	遢
cebw	遣
uc	遣
ldjw	遧
hnpw	遨
yfpw	遨
gow	適
lnjw	適
xwn	適
umw	遪
uuuw	遪
jcsw	遫
vspw	遫
rfdw	遭
rorw	遭
rw	遭
lrfw	遮
ueqw	遯
fnnw	遰
mgw	遱
cnw	遲
cwsw	遲
cw	遲
rbbw	遳
mcsw	遴
mcw	遴
beaw	遵
bw	遵
yrw	遶
yyyw	遶
cdow	遷
cdpw	遷
gwn	遷
gw	遷
flfw	選
olow	選
ow	選
srw	選
mnbw	遹
mnrw	遹
cemw	遺
qwn	遺
oobw	遻
dbdw	遼
lwn	遼
wwn	遼
zeqw	遽
zwn	遽
zw	遽
zww	遾
colw	避
pwn	避
pdfw	邀
pw	邀
enw	邁
rqnw	邁
rwv	邁
vn	邁
vwn	邁
ndsw	邂
nbbw	邃
nrbw	邃
bwn	還
feow	還
own	還
loow	邅
jdw	邆
nsw	邇
rwn	邇
eqgw	邈
eqpw	邈
uqgw	邈
uqpw	邈
pmnw	邉
daw	邊
dwn	邊
mw	邊
pmnw	邊
sobw	邋
soxw	邋
swn	邋
pqcw	邍
fcw	邏
fsvw	邏
llbw	邐
lwn	邐
ocl	邑
tbi	邒
ubi	邓
flb	邔
socl	邕
soc	邕
ebi	邖
gbi	邗
ubi	邘
fbi	邙
gbi	邚
ibi	邛
qnb	邞
lrb	邟
bdb	邠
fbi	邡
kbi	邢
kbv	邢
ebi	那
kbi	邤
kbi	邥
fbi	邦
rrb	邧
ebi	邨
fbi	邩
xbi	邪
ybi	邪
focl	邫
foc	邫
nob	邭
gbi	邯
uob	邰
keb	邱
pob	邱
hpb	邲
beb	邳
ebi	邴
enbb	邴
dob	邵
ffb	邶
wbi	邷
xeb	邸
neb	邹
fkb	邼
yyb	邽
sbb	邾
ssb	邾
yab	邿
drkb	郀
xbi	郀
xbi	郁
xub	郁
lhb	郂
aob	郃
xxub	郄
pbi	郅
yob	郆
ndb	郇
fob	郈
ggb	郉
kbi	郉
lxb	郊
pmb	郋
zbi	郍
abi	郎
adkb	郎
adub	郎
pzwb	郔
abi	郕
aqnb	郕
dbi	郖
xxnb	郗
opob	郘
ajnb	郙
ibi	郙
wob	郚
ezb	郛
sob	郜
yfb	郝
abi	郞
adkb	郞
gbi	郟
tbi	郠
tqxb	郠
eob	郡
okb	郢
jnzb	郣
bbob	郤
wbi	郤
yub	郤
mbb	郥
lob	部
xxb	郩
xxub	郩
jegb	郪
jgb	郪
pgb	郫
pqgb	郫
hub	郬
lhzb	郭
lozb	郭
lzb	郭
nbi	郮
nyob	郮
ffb	郯
rub	郰
bkb	郱
lbi	郲
grb	郳
ttb	郴
gbi	郵
gjjb	郵
iqb	郵
wdub	郷
xi	郷
madb	郹
ccsc	郺
ccsl	郺
mesb	郻
mlsb	郻
wbi	郼
wosb	郼
hbi	都
yb	都
ypab	都
ypdb	都
fdgb	郾
cmb	郿
rxob	鄀
ffub	鄁
obi	鄂
oorb	鄂
abi	鄃
aurb	鄃
cyb	鄄
pcnb	鄅
ncb	鄆
pfvb	鄇
jedb	鄈
jgnb	鄈
kbi	鄈
wab	鄉
wadb	鄉
xi	鄉
wrb	鄊
giub	鄋
gub	鄋
leob	鄌
ndlb	鄍
pmhb	鄎
fkab	鄏
lwqb	鄐
efeb	鄑
euub	鄑
neb	鄒
nenb	鄒
pmab	鄓
wfb	鄔
wadb	鄕
wdub	鄕
wpdb	鄕
xi	鄕
ombb	鄖
lhnb	鄗
lnob	鄗
lonb	鄗
qbi	鄗
lenb	鄘
obv	鄙
ojob	鄙
olob	鄙
rddb	鄚
sqtb	鄛
lbb	鄜
eebb	鄝
emb	鄝
rcb	鄞
cuab	鄟
jqub	鄟
xbi	鄟
urkb	鄠
ntb	鄡
ezkb	鄢
ldjb	鄣
dfub	鄤
mbi	鄤
nfb	鄥
ekb	鄦
glb	鄦
vffb	鄦
jdb	鄧
ubi	鄧
bocl	鄨
boc	鄨
snsc	鄨
snsl	鄨
eiob	鄩
vmbb	鄪
bbi	鄫
bqdb	鄫
bwfb	鄬
ewfb	鄬
wbi	鄬
ywfb	鄬
bbv	鄭
bedb	鄭
bgnb	鄭
gbi	鄭
ddmb	鄮
ombb	鄮
bhbb	鄯
bhrb	鄯
bkbb	鄯
bkrb	鄯
apb	鄰
atb	鄰
bmcs	鄰
bmc	鄰
mcb	鄰
mcsb	鄰
xb	鄰
mqb	鄱
obi	鄲
ooqb	鄲
xbi	鄳
febb	鄴
fsb	鄴
ooob	鄵
adb	鄶
aqdb	鄶
fdb	鄷
rorb	鄷
rfnb	鄸
rumb	鄹
rupb	鄹
ruqb	鄹
lbi	鄺
lkb	鄺
lreb	鄺
qaqb	鄻
qnqb	鄻
qaqb	鄼
qnqb	鄼
lqbb	鄽
lqrb	鄽
tdnb	鄾
tmnb	鄾
ybi	鄾
rob	鄿
roob	鄿
rfob	酀
rofb	酀
nobb	酁
uoob	酃
rbi	酄
roob	酄
evnb	酅
fdb	酆
ffeb	酆
fifb	酆
iffb	酆
rorb	酆
srsb	酇
lbi	酈
llbb	酈
eov	酉
eo	酉
eti	酊
beo	酋
ena	酌
efl	配
eaa	酎
eal	酏
egj	酐
euj	酑
weo	酒
aye	酓
ekj	酔
eml	酕
ekl	酖
enr	酖
exu	酗
eru	酘
edj	酙
ebd	酚
ezo	酟
eto	酠
enf	酡
evf	酢
ego	酣
ejo	酤
ehn	酥
ena	酧
jaqe	酨
eco	酩
epo	酪
ebk	酫
eyv	酬
eyyy	酬
eyy	酬
qy	酬
eneo	酮
efd	酯
eok	酲
ewu	酳
ebh	酴
eypz	酵
evom	酶
eso	酷
ehx	酸
eubp	酸
eurp	酸
eea	酹
eua	酹
eajq	酺
eij	酺
eez	酻
ets	酼
eve	醀
ecew	醁
ett	醂
edil	醃
edql	醃
exl	醃
eni	醄
enwu	醄
elo	醅
eaqq	醆
ekx	醆
eloz	醇
elz	醇
eff	醈
ejj	醉
euuu	醊
erd	醋
edb	醌
edez	醍
ejn	醍
eaqo	醎
eko	醎
eho	醏
eypd	醏
efu	醐
ejou	醐
efbu	醑
eyzu	醑
eds	醒
ekf	醓
enrf	醓
eld	醕
elod	醕
edf	醖
eobf	醖
egiu	醙
egu	醙
emw	醚
erbk	醛
epqu	醜
epru	醜
eva	醜
ebhi	醝
ebki	醝
edf	醞
eobf	醞
eta	醞
ffne	醟
ecf	醠
enbe	醡
enbf	醡
enre	醡
enrf	醡
exof	醢
eleo	醣
ecrs	醥
efoo	醧
efx	醧
ela	醨
elxu	醨
ewuu	醨
erfd	醩
erod	醩
eeem	醪
eem	醪
fvde	醫
fvd	醫
gce	醬
geae	醬
guae	醬
efb	醭
efed	醭
evn	醭
evf	醮
etsf	醯
ecdj	醰
exj	醰
efx	醱
ejqu	醱
effk	醲
enk	醲
erok	醲
efyg	醳
efy	醳
efd	醴
erod	醴
ezeq	醵
ezn	醵
eldh	醷
eur	醹
eutr	醹
egqf	醺
efa	醻
eyya	醻
efof	醼
erff	醼
erof	醼
euoo	醽
eltm	醾
elts	醿
eadk	釀
ean	釀
ek	釀
eln	釀
elok	釀
pfb	釁
sned	釁
eefa	釂
ellb	釃
elts	釄
eoop	釅
eop	釅
eox	釅
mn	釆
etn	采
etiq	釉
miq	釉
etcn	釋
etfg	釋
etfy	釋
etuq	釋
mcn	釋
mfyg	釋
mfy	釋
mg	釋
muq	釋
qe	里
gqe	重
gq	重
qui	野
deq	量
qbpq	釐
yspq	釐
ae	金
all	釓
azl	釔
azz	釔
awi	釕
adp	釖
ari	釗
ati	釘
apa	釙
akl	釚
akx	釚
akz	釚
adx	釛
ady	釛
bxa	釜
bxge	釜
ajj	針
abn	釞
abn	釟
arl	釠
arz	釠
arp	釢
ana	釣
amp	釤
asa	釥
aoo	釦
asi	釧
azj	釨
ara	釩
auj	釪
ark	釫
agj	釬
aie	釭
aup	釮
ada	釰
adn	釱
afl	釲
aol	釲
avz	釳
aax	釴
aua	釵
aal	釶
aye	釷
aca	釸
agx	釹
aei	釽
aen	釽
axp	釾
ayp	釾
aki	釿
acl	鈀
afy	鈁
akl	鈂
akj	鈃
adj	鈄
aue	鈅
abu	鈆
aqn	鈇
aba	鈈
anb	鈉
aha	鈊
apf	鈋
ajn	鈌
ael	鈍
anu	鈎
aqi	鈏
aay	鈐
alu	鈑
apu	鈒
arn	鈒
ake	鈓
asp	鈔
aee	鈕
abd	鈖
aur	鈗
aju	鈘
azu	鈙
abl	鈚
aaq	鈛
axu	鈜
anb	鈞
anr	鈞
aru	鈠
atn	鈢
afk	鈣
ado	鈤
afn	鈥
ada	鈦
alr	鈧
zfa	鈭
acf	鈮
aee	鈯
aeu	鈯
aln	鈰
aox	鈱
aga	鈲
agn	鈲
ato	鈳
aap	鈴
aat	鈴
aenb	鈵
aen	鈵
atnb	鈵
auo	鈶
ajo	鈷
aaxu	鈸
aaxx	鈸
aax	鈸
apx	鈹
aka	鈺
abo	鈻
avf	鈼
aba	鈽
axn	鈽
aiq	鈾
aqo	鈿
aqi	鉀
abm	鉁
asn	鉄
aff	鉅
azo	鉆
anf	鉈
alw	鉉
ado	鉊
anl	鉋
anol	鉋
ahn	鉌
ahp	鉍
ase	鉎
ame	鉏
alo	鉐
apd	鉑
aak	鉒
avn	鉓
afn	鉔
afo	鉕
apb	鉖
ago	鉗
aob	鉙
adp	鉚
abo	鉛
aro	鉛
apa	鉜
ale	鉝
aaqi	鉞
abe	鉟
acn	鉠
abj	鉡
ate	鉢
ayu	鉣
ano	鉤
anu	鉤
aat	鉥
aez	鉦
aom	鉧
asl	鉪
ado	鉫
amo	鉬
ade	鉭
aii	鉮
aiqi	鉮
aub	鉯
aeo	鉰
ayeo	鉰
afp	鉲
akr	鉶
alx	鉸
acc	鉹
arj	鉺
apo	鉻
abk	鉼
aaxi	鉽
aus	鉾
aao	鉿
adk	銀
and	銁
ayyy	銂
atl	銃
atr	銃
apno	銄
aneo	銅
atd	銆
aln	銇
ayy	銈
aej	銉
aaqa	銊
aaqb	銊
aaqe	銊
aaqv	銊
apk	銋
axiz	銌
ape	銍
iraa	銎
iza	銎
amj	銏
anne	銏
dra	銐
asr	銑
agg	銒
akj	銒
abk	銓
abj	銔
apj	銔
aen	銕
ajqb	銕
asb	銖
ass	銖
afo	銗
aco	銘
adrk	銙
axk	銙
ara	銚
arbb	銚
ago	銛
aiv	銜
atv	銜
miai	銜
miat	銜
apt	銝
nda	銞
aypf	銠
ayo	銡
arw	銢
aun	銢
ago	銣
amn	銤
alk	銥
aod	銦
aser	銧
ang	銨
aku	銩
axe	銪
axu	銪
adcl	銫
adc	銫
ancl	銫
anc	銫
ark	銬
aypk	銬
aaf	銭
akx	銭
lfa	銮
adg	銲
abor	銳
jka	銴
asx	銵
aajw	銶
ana	銶
asu	銷
aerl	銸
arl	銸
ahr	銹
abqp	銻
atp	銻
abby	銼
aiw	銾
atj	銿
atnq	銿
ade	鋀
aopo	鋁
aov	鋁
avom	鋂
aadk	鋃
aan	鋃
aefu	鋄
alj	鋅
ynba	鋆
ynra	鋆
amb	鋇
wgna	鋈
wpda	鋈
ajcs	鋉
avs	鋉
abbo	鋊
awo	鋊
apzw	鋋
akw	鋌
ajnz	鋍
anrr	鋎
agn	鋏
anxu	鋐
ahx	鋑
aubp	鋑
aurp	鋑
apf	鋒
ahr	鋓
ael	鋔
ancr	鋔
ayh	鋕
aeg	鋖
aou	鋗
aoed	鋘
aogn	鋘
aokd	鋘
awo	鋙
pipa	鋚
acc	鋛
aoz	鋜
aea	鋝
aua	鋝
aesi	鋞
asi	鋞
aui	鋞
auy	鋞
aenu	鋟
arx	鋟
afk	鋠
aayo	鋡
aez	鋢
amd	鋤
aok	鋥
acyo	鋦
aono	鋦
amr	鋧
aix	鋨
arf	鋩
aajq	鋪
aij	鋪
hra	鋫
abor	鋭
aaqn	鋮
aaqy	鋮
aay	鋮
aso	鋯
aqe	鋰
aaxh	鋱
afa	鋳
aru	鋷
acjo	鋸
aek	鋹
ancp	鋺
rua	鋻
anbe	鋼
anx	鋼
aqj	鋽
azdj	鋽
ani	鋾
anwu	鋾
asno	鋿
aam	錀
aqt	錁
aybp	錂
ayrp	錂
ayx	錂
wpa	錃
acew	錄
aew	錄
aw	錄
ewa	錄
ewn	錄
hda	錅
ahu	錆
alo	錇
abnl	錈
abnp	錈
apl	錈
axd	錉
ajj	錊
auu	錋
aelg	錌
apg	錍
apqg	錍
ang	錎
aoe	錏
ave	錐
abto	錒
abkr	錓
awd	錔
adb	錕
fsua	錖
ahg	錗
age	錘
agjy	錘
asq	錙
aee	錚
ane	錚
adjr	錛
aayh	錜
anrs	錝
ans	錝
alhz	錞
aloz	錞
alz	錞
aff	錟
anez	錠
anz	錠
adto	錡
avo	錡
aaf	錢
aaqq	錢
akx	錢
aq	錢
auuu	錣
akb	錤
atu	錥
apdn	錦
apj	錦
anb	錧
arq	錨
add	錩
afb	錪
arob	錪
adnm	錫
aep	錫
acs	錬
ajqs	錬
ano	錭
anyo	錭
aojo	錮
ard	錯
atf	錰
akk	錱
acew	録
aew	録
azf	錳
aqu	錴
ayby	錴
aye	錴
ayry	錴
arpf	錵
ahk	錶
aln	錸
azu	錹
adrs	錼
ami	鍆
amy	鍆
abpd	鍇
arc	鍈
adez	鍉
ajn	鍉
acs	鍊
ajqs	鍊
aonb	鍋
aqo	鍋
wsra	鍌
alru	鍍
akm	鍎
axm	鍎
awj	鍏
awos	鍏
axup	鍐
avdp	鍑
avx	鍑
amt	鍒
aor	鍓
aok	鍔
aook	鍔
anc	鍕
akbl	鍖
aklb	鍖
aklr	鍖
akl	鍖
akrl	鍖
alnn	鍗
ambr	鍘
wrba	鍙
adem	鍚
advm	鍚
aep	鍚
aeru	鍛
aofu	鍜
aox	鍜
aqnu	鍝
azmb	鍞
ads	鍟
apdk	鍠
aqk	鍡
aeoq	鍢
ardo	鍣
agg	鍤
afdd	鍥
ahdd	鍥
afva	鍦
ani	鍧
ajed	鍨
ajgn	鍨
akn	鍨
aro	鍩
arxo	鍩
mpa	鍪
hfa	鍫
ahf	鍬
apfd	鍭
aai	鍮
aaur	鍮
aegu	鍰
aex	鍰
ast	鍱
aoxd	鍲
rae	鍳
rvaa	鍳
rvea	鍳
adi	鍴
aer	鍴
aetr	鍴
aew	鍵
aqh	鍶
adyy	鍷
afu	鍸
ajou	鍸
anee	鍹
ane	鍹
aho	鍺
aypd	鍺
adl	鍻
adnl	鍻
aaqo	鍼
ako	鍼
afm	鍽
agq	鍾
aseq	鍿
apim	鎀
abkd	鎂
awlk	鎃
abhi	鎈
abki	鎈
adee	鎉
agy	鎊
alnf	鎊
anfo	鎋
anho	鎋
aqn	鎌
ajns	鎍
akm	鎎
wae	鎏
wtsa	鎏
aewu	鎐
auu	鎐
auwu	鎐
ace	鎑
ayuf	鎑
afka	鎒
abue	鎓
anbo	鎔
anw	鎔
aleo	鎕
asmb	鎖
aado	鎗
abp	鎗
aeot	鎘
abeu	鎙
apbw	鎚
aaja	鎛
aia	鎛
zrua	鎜
arao	鎝
aro	鎝
apob	鎞
auut	鎟
afez	鎠
abew	鎡
alww	鎡
arww	鎡
awf	鎢
ffna	鎣
adsr	鎤
pae	鎥
pipa	鎥
addq	鎦
aoq	鎦
aed	鎧
avj	鎨
axau	鎩
axtu	鎩
agiu	鎪
agu	鎪
alho	鎬
alno	鎬
aloo	鎬
aqo	鎬
ab	鎭
afmb	鎭
ajb	鎭
ajmb	鎭
ab	鎮
ajb	鎮
ajmb	鎮
aab	鎯
aadb	鎯
abef	鎰
aye	鎰
ayok	鎱
asnr	鎲
apmt	鎳
apmh	鎴
aneq	鎵
amf	鎷
avr	鎸
asmb	鎻
azof	鏀
azox	鏀
asqt	鏁
afoo	鏂
afvd	鏃
acua	鏄
ajqa	鏄
aqa	鏄
axa	鏄
apiu	鏅
aoa	鏆
aomb	鏆
aoxb	鏆
afvz	鏇
acw	鏈
hnpa	鏊
yfpa	鏊
arnb	鏋
ardd	鏌
aqs	鏍
aqjq	鏎
aqj	鏎
aqrj	鏎
aqrq	鏎
affe	鏏
aeem	鏐
aem	鏐
alno	鏑
axo	鏑
audm	鏒
aum	鏒
auum	鏒
apa	鏓
apoh	鏓
ana	鏔
aneb	鏔
alb	鏕
lba	鏖
aruy	鏗
agca	鏘
agea	鏘
agua	鏘
aev	鏙
aaqs	鏚
asnn	鏛
asny	鏜
adfu	鏝
amx	鏝
aleq	鏞
alps	鏟
alp	鏟
awls	鏟
apfw	鏠
ac	鏡
aldr	鏡
acrs	鏢
alrf	鏣
amg	鏤
anpd	鏥
amiz	鏦
yae	鏧
ycra	鏧
cka	鏨
ack	鏩
arfd	鏪
arod	鏪
ahrt	鏫
azh	鏬
aeth	鏭
amh	鏭
alew	鏮
abo	鏳
abqd	鏳
alo	鏴
aozo	鏴
aaj	鏵
arjq	鏵
arrj	鏵
arrq	鏵
avt	鏶
afb	鏷
afed	鏷
avn	鏷
ach	鏸
acuh	鏸
ajqh	鏸
aqoc	鏹
aquc	鏹
afx	鏺
ajqu	鏺
amcs	鏻
amc	鏻
azjs	鏼
azj	鏼
aeh	鏽
ahr	鏽
arup	鏾
arx	鏾
asnt	鏿
aceb	鐀
aqa	鐀
aefq	鐂
aerq	鐂
aoq	鐂
axq	鐂
ayfq	鐂
aqer	鐃
ayr	鐃
ayyr	鐃
aka	鐄
areb	鐄
artb	鐄
bae	鐅
snsa	鐅
bbea	鐆
amq	鐇
agno	鐈
ago	鐈
apdo	鐈
aflb	鐉
aolb	鐉
abdm	鐊
abe	鐊
awdm	鐋
awe	鐋
ancq	鐌
ann	鐌
amno	鐍
avf	鐎
abea	鐏
adbs	鐐
ala	鐐
asyo	鐑
affd	鐒
alhp	鐓
alop	鐓
alzp	鐓
acdj	鐔
axj	鐔
akkd	鐕
awb	鐖
awwb	鐖
amu	鐗
aci	鐘
acj	鐘
alq	鐘
ajd	鐙
aoh	鐚
adls	鐛
lhza	鐜
loza	鐜
lzpa	鐜
aea	鐞
afia	鐞
aqad	鐟
aqnd	鐟
abd	鐠
abed	鐠
abod	鐠
amd	鐧
avmb	鐨
abew	鐩
azqd	鐪
avm	鐫
avu	鐫
azas	鐬
apnd	鐭
apob	鐭
albf	鐮
alpq	鐮
alq	鐮
alt	鐰
aoot	鐰
aae	鐱
aaob	鐱
aoa	鐱
afnc	鐲
auq	鐳
ajak	鐵
ak	鐵
asn	鐵
ayoq	鐵
afek	鐶
aon	鐶
arst	鐷
acn	鐸
afyg	鐸
afy	鐸
auq	鐸
aqow	鐹
ase	鐺
asnq	鐺
aso	鐺
azeq	鐻
azn	鐻
aja	鐼
ajrb	鐼
aybw	鐽
ayw	鐽
aldh	鐿
aenp	鑀
ahx	鑀
agqf	鑂
aeev	鑃
afa	鑄
ayya	鑄
afft	鑅
aaa	鑆
afa	鑆
afea	鑆
awh	鑇
awr	鑇
arx	鑈
arc	鑉
aryf	鑉
arvu	鑊
cesa	鑋
ansb	鑌
mbma	鑍
sae	鑍
afcb	鑎
afq	鑎
anht	鑏
ant	鑏
aur	鑐
autr	鑐
af	鑑
arf	鑑
arvf	鑑
rfa	鑒
rvaa	鑒
rvea	鑒
akkb	鑕
arfa	鑖
arfb	鑖
arfv	鑖
ahdw	鑗
aqab	鑚
aqnb	鑚
alk	鑛
alrb	鑛
asnb	鑜
arpw	鑝
asfs	鑞
asl	鑞
asns	鑞
asos	鑞
ayfb	鑟
aym	鑟
arn	鑠
awpt	鑠
azu	鑡
azqh	鑢
albf	鑣
adrw	鑤
aal	鑨
alul	鑨
akoo	鑩
atoe	鑩
atol	鑩
azqf	鑪
aaa	鑫
armr	鑬
arvr	鑬
avl	鑬
amcs	鑭
amjs	鑭
amn	鑭
arwa	鑮
abbe	鑯
aaom	鑰
aue	鑰
anoa	鑱
aln	鑲
alok	鑲
anjz	鑳
aevo	鑴
are	鑵
arov	鑵
arar	鑶
arrr	鑷
aqqy	鑸
ammv	鑺
atxh	鑻
afc	鑼
afsv	鑼
akz	鑽
asrb	鑽
azo	鑽
issa	鑾
lfa	鑾
sisa	鑾
feba	鑿
fgia	鑿
fgra	鑿
azed	钀
ammu	钁
asnf	钂
acwc	钃
ekn	長
kn	長
eugn	镺
eupd	镺
eusn	镻
euce	镼
euds	镽
eul	镽
mi	門
my	門
mpp	閁
mee	閂
mbn	閃
mti	閅
mse	閆
mfa	閇
mgj	閈
mup	閉
kj	開
mkj	開
mlr	閌
mfy	閍
mxu	閎
mke	閏
mml	閐
mtn	閑
mtv	閑
mue	閒
mdo	間
mwx	閔
mxp	閕
myp	閕
mqi	閘
mjn	閙
mln	閙
mle	閚
mpj	閛
mto	閜
mur	閞
mhp	閟
mlh	閡
mbed	関
mbgn	関
mgn	関
mpo	閣
mao	閤
mpaq	閥
mqv	閥
mrb	閧
myy	閨
mca	閩
mot	閫
madk	閬
man	閬
mopo	閭
mkw	閮
mws	閯
mge	閰
mbor	閱
mr	閱
mbor	閲
mr	閲
mcj	閳
mve	閵
mdd	閶
xatb	閷
xtmb	閷
moe	閸
mdil	閹
mdql	閹
mxl	閹
mdw	閺
mdg	閻
meg	閻
mng	閻
mfbb	閼
mxd	閽
maqe	閾
mhe	閾
menu	閿
mhl	闀
mrbl	闀
mrbp	闀
mmi	闁
mmy	闁
mbnp	闂
mpl	闂
mmad	闃
mcg	闄
mvx	闄
mmw	闅
mooo	闆
mld	闇
mwj	闈
mwos	闈
mcy	闉
mwgo	闊
wmgo	闊
mjed	闋
mjgn	闋
mkn	闋
mcs	闌
mjqs	闌
mn	闌
mho	闍
mypd	闍
mfmb	闐
mjb	闐
mjmb	闐
mpmt	闑
mdee	闒
med	闓
mefl	闓
mce	闔
myuf	闔
mbei	闕
mmf	闖
mss	闗
mwwf	闗
mqar	闚
mql	闚
mqnr	闚
msny	闛
bed	關
bgn	關
mbed	關
mbgn	關
mf	關
mgn	關
mwwf	關
mmbp	闝
mirp	闞
mtrp	闞
maoe	闟
mceb	闠
mqa	闠
moj	闡
mooj	闡
mcol	闢
mpj	闢
msnq	闣
mso	闣
mfek	闤
mon	闤
mybw	闥
myw	闥
pbj	阜
bi	阝
bdx	阞
bdy	阞
bzj	阠
bzx	阠
bgj	阡
ber	阢
bvz	阣
bal	阤
bfn	阦
bdj	阧
blp	阨
bxj	阩
blu	阪
buv	阪
bba	阫
blr	阬
bur	阭
brr	阮
bze	阯
bbl	阰
bjj	阱
bfy	防
bdo	阳
bue	阴
bez	阷
byu	阹
bxe	阺
bme	阻
bvf	阼
bzo	阽
bap	阾
bat	阾
bto	阿
bnf	陀
bva	陁
bpx	陂
benb	陃
ben	陃
bpa	附
bcc	陊
bel	陋
benl	陋
blv	陋
btnl	陋
btd	陌
bps	降
bsb	陎
bss	陎
bxe	陏
bxu	陏
bdk	限
bri	陑
btnr	陑
bdrk	陓
bxk	陓
blh	陔
bhx	陖
bubp	陖
burp	陖
besi	陘
bsi	陘
bui	陘
buy	陘
bfk	陙
beaz	陚
bwe	陚
bby	陛
bgn	陜
bgn	陝
bxy	陞
bzs	陟
bajq	陠
bij	陠
byz	陡
bnrr	院
br	院
bcj	陣
bat	除
bbh	除
blo	陪
brss	陫
bru	陬
bdto	陭
bvo	陭
bve	陮
bam	陯
bafu	陰
bayt	陰
bayu	陰
bbeu	陰
bue	陰
bnm	陱
bge	陲
bgjy	陲
bcs	陳
bjqs	陳
bpg	陴
bpqg	陴
bpv	陵
bybp	陵
byrp	陵
byv	陵
byx	陵
bni	陶
bnwu	陶
bng	陷
bqu	陸
byby	陸
bye	陸
byry	陸
bxd	陹
bcy	陻
bho	陼
bypd	陼
bdem	陽
bdo	陽
bdvm	陽
bep	陽
bm	陽
brd	陾
btnd	陾
bfg	陿
bgq	隀
bfdg	隁
bbeu	隂
bai	隃
baur	隃
bdez	隄
bjn	隄
bqnu	隅
bpes	隆
bps	隆
bs	隆
baqg	隇
bqk	隈
bgy	隉
bbeq	隊
bbn	隊
bq	隊
bxiu	隋
bld	隌
bpdk	隍
bbpd	階
bbr	階
bd	階
bxuw	随
bxw	随
bed	隑
bbef	隒
bqn	隒
bxii	隓
beot	隔
bt	隔
bomb	隕
bwf	隖
bpqu	隗
bpru	隗
bva	隗
bbef	隘
bye	隘
bsds	隙
bsps	隙
bja	際
bjrs	際
brs	際
bg	障
bjv	障
bldj	障
bnf	隝
bhnp	隞
byfp	隞
bsqt	隟
beeh	隠
bh	隠
blps	隡
bwls	隡
byr	隢
byyr	隢
bmcs	隣
bmc	隣
bceb	隤
bqa	隤
bjd	隥
bbew	隧
bxiw	隨
bxn	隨
bxuw	隨
xw	隨
bpnd	隩
bpob	隩
bac	險
bae	險
baob	險
base	險
boa	險
bja	隫
bjrb	隫
brx	隬
bur	隭
butr	隭
bwh	隮
bfa	隯
byya	隯
bdwf	隰
beeh	隱
beih	隱
bh	隱
bneh	隱
bsmf	隲
bxif	隳
bxih	隳
bakp	隴
bal	隴
blul	隴
bzdq	隵
ewa	隶
ewn	隶
yrsw	隷
ewa	隸
trsw	隸
twv	隸
yrsw	隸
ve	隹
vux	隻
vjj	隼
vrp	隽
axv	隿
sve	雀
lpv	雁
ayv	雂
kve	雃
xuv	雄
xve	雅
yve	雅
vtn	集
vt	集
fve	雇
rve	雈
vdv	雉
nov	雊
vmi	雋
vmy	雋
vui	雋
vuy	雋
zfv	雌
lwv	雍
mve	雎
zve	雐
jtv	雑
ktv	雑
cov	雒
pov	雒
bhv	雓
vve	雔
nve	雕
nvv	雕
nyov	雕
oca	雖
ocv	雖
uca	雖
ucv	雖
jbv	雗
jdjv	雗
naeu	雘
nlru	雘
uux	雙
vvu	雙
re	雚
roov	雚
nenv	雛
nev	雛
jtv	雜
ktn	雜
ktv	雜
socv	雝
eqaf	雞
eqnf	雞
evv	雞
ewdf	雞
ewdv	雞
unf	雞
evno	雟
rvno	雟
eebv	雡
emv	雡
la	離
lve	離
lxuv	離
wunv	離
rcv	難
uve	難
snv	雤
vvv	雥
vvv	雦
vvvt	雧
ua	雨
uke	雩
urk	雩
uee	雪
utn	雬
upu	雭
urn	雭
uml	雮
uwx	雯
ubd	雰
ufy	雱
uta	雲
ule	雴
ucn	雵
uap	零
uat	零
uqo	雷
ugo	雸
unl	雹
unol	雹
ump	雺
iql	電
uiql	電
uql	電
ulo	雼
uhj	雽
ura	雿
urbb	雿
uri	需
utnr	需
uwt	霂
usu	霄
uio	霅
ukw	霆
ufk	震
uwjn	霈
uwln	霈
uvom	霉
ef	霊
ueo	霊
uoow	霊
urfe	霊
ujeg	霋
ujg	霋
uno	霌
unyo	霌
uve	霍
uvv	霍
uv	霍
ulg	霎
urss	霏
uwqu	霐
uwzo	霑
utay	霒
ugr	霓
uwak	霔
ute	霕
utt	霖
uwap	霗
uwat	霗
uwno	霘
urc	霙
ump	霚
uqqq	霛
utm	霜
uooo	霝
uofu	霞
uox	霞
uwrb	霟
ulay	霠
uulk	霢
uomb	霣
uddq	霤
uoq	霤
unrq	霥
uttm	霦
umpd	霧
upd	霧
uca	霨
ucra	霨
ulhb	霩
ulob	霩
ulzb	霩
uwek	霪
ueed	霫
uqrb	霬
uwkl	霮
uwkr	霮
uwk	霮
ujd	霯
urup	霰
urx	霰
umno	霱
ulo	露
uozo	露
ubps	霳
utew	霴
uorq	霵
uwg	霶
uwlf	霶
uddm	霷
ude	霷
crcu	霸
urcu	霸
uuv	霸
ucol	霹
upj	霹
umip	霺
utkm	霼
uwh	霽
ueqq	霾
uuqq	霾
umpm	霿
urnq	靀
uqqq	靁
uld	靂
ulhz	靂
uvv	靃
uidl	靄
uid	靄
utvb	靅
utew	靆
uakp	靇
ual	靇
ulul	靇
efn	靈
ef	靈
uoow	靈
uwv	靈
utep	靉
uth	靉
uwlz	靋
uquq	靐
hnl	靑
hue	靑
hue	青
ezhl	靕
ezhu	靕
lhu	靖
hudc	靘
hudl	靘
hunc	靘
hunl	靘
hnle	静
hune	静
humr	靚
hunz	靛
huee	靜
hune	靜
hz	靜
hnlm	靝
hukm	靝
rss	非
rs	非
rssm	靟
ks	靠
sors	靠
ltte	靡
ltts	靡
tj	面
toh	面
too	靣
tohl	靤
tohn	靤
tohr	靦
tohb	靧
tohq	靧
lduh	靨
lduo	靨
ytoh	靨
rcj	革
rct	靪
rcg	靬
rcda	靭
rcna	靮
rcy	靯
rcer	靰
rcay	靲
rck	靳
rcpf	靴
rccl	靶
rcc	靶
rcqi	靷
rcpu	靸
rcrn	靸
rcqb	靺
rcys	靺
rcm	靻
rcde	靼
rcb	靽
rcs	靾
rcwd	靿
rcdo	鞀
rcp	鞁
rch	鞂
rcqu	鞃
rcnl	鞄
rcn	鞄
rcc	鞅
rcod	鞇
rcao	鞈
rcrb	鞉
rcr	鞉
rcyo	鞊
rcyy	鞋
ngrc	鞌
rcng	鞍
rcdk	鞎
ic	鞏
irac	鞏
iraj	鞏
ira	鞏
izrc	鞏
izx	鞏
rcok	鞓
rcdr	鞔
rce	鞔
rcnr	鞔
pipc	鞗
rcsu	鞘
rcou	鞙
rcni	鞚
rclo	鞛
rcwd	鞜
rcso	鞝
rcpg	鞞
rclz	鞟
rcnm	鞠
rcjl	鞡
rcst	鞢
rcmt	鞣
yyac	鞤
rcar	鞥
rchf	鞦
rcdb	鞨
rcdl	鞨
rcd	鞨
rcsr	鞩
mprc	鞪
rcni	鞫
rcew	鞬
rcpt	鞭
rcpx	鞭
rcdz	鞮
rcj	鞮
rceg	鞱
rcjy	鞲
rcro	鞳
rcrq	鞴
rced	鞵
zruc	鞶
eonc	鞷
rcqq	鞸
rcq	鞸
rclb	鞹
rcsy	鞺
rcmg	鞻
rcgo	鞽
rcg	鞽
rcpo	鞽
rca	鞾
rcrq	鞾
rcwb	鞿
rclf	韀
rcee	韁
rcdw	韃
rcyw	韃
rcru	韄
rcdf	韅
rcds	韅
rccw	韆
rcyb	韇
rcym	韇
rcra	韈
rcrb	韈
rcrv	韈
rcrf	韉
rcrm	韊
rcrs	韊
wj	韋
wos	韋
wda	韌
wosa	韌
wosx	韌
wosy	韌
waxx	韍
wax	韍
wosa	韍
wosx	韍
woss	韎
wost	韎
wqb	韎
wys	韎
bnws	韏
bnw	韏
wao	韐
woso	韐
wosu	韒
wsu	韒
jdjs	韓
jdjw	韓
jwj	韓
jwos	韓
wek	韔
wosk	韔
wlhz	韕
wloz	韕
wlz	韕
wosz	韕
wmt	韖
wost	韖
wnc	韗
wosc	韗
wost	韘
wst	韘
dezs	韙
dezw	韙
jwj	韙
jwos	韙
wosc	韚
wrc	韚
weg	韜
wosg	韜
wje	韝
wjny	韝
wosj	韝
wosy	韝
wdf	韞
wobf	韞
wosf	韞
wosj	韟
wpdj	韟
waj	韡
wosa	韡
wosq	韡
wrjq	韡
wrrq	韡
wcuh	韢
wjqh	韢
wosh	韢
wfnc	韣
wosc	韣
wosa	韤
wosb	韤
wosv	韤
wrfa	韤
wrfb	韤
wrfv	韤
wjm	韥
wosb	韥
wosm	韥
wyfb	韥
wym	韥
rrse	韭
rsse	韭
rrse	韮
jaqe	韯
zcue	韰
bbae	韱
wrse	韲
ldo	音
ldnb	韵
ldnr	韵
lddo	韶
ldpf	韸
ldpk	韹
ldrc	韺
ldob	韻
ldpw	韼
ayed	韽
ycrd	韾
yld	韾
opno	響
wabd	響
wadd	響
wd	響
xld	響
ldru	頀
ta	頁
tmb	頁
tta	頂
ttmb	頂
fta	頃
ftmb	頃
ftv	頃
kta	頄
ktmb	頄
ita	項
itmb	項
sta	順
stmb	順
gta	頇
gtmb	頇
mta	須
mtmb	須
kta	頊
ktmb	頊
lptb	頋
lpt	頋
butb	頌
but	頌
jutb	頍
jut	頍
kta	頎
ktmb	頎
lrtb	頏
lrt	頏
ub	預
uta	預
utmb	預
rrtb	頑
rrt	頑
bdtb	頒
bdt	頒
eta	頓
etmb	頓
iqtb	頔
iqt	頔
zotb	頕
zot	頕
bta	頖
btmb	頖
pta	頗
ptmb	頗
aptb	領
apt	領
attb	領
att	領
eztb	頙
ezt	頙
sitb	頚
sit	頚
uitb	頚
uit	頚
uytb	頚
uyt	頚
lta	頛
ltmb	頛
aotb	頜
aot	頜
lxtb	頝
lxt	頝
ngtb	頞
ngt	頞
cotb	頟
cot	頟
potb	頟
pot	頟
nlpb	頠
nlpt	頠
nptb	頠
npt	頠
yotb	頡
yot	頡
gotb	頢
got	頢
rta	頤
rtmb	頤
lhtb	頦
lht	頦
pbtb	頧
pbt	頧
eetb	頨
eet	頨
bktb	頩
bkt	頩
mta	頪
mtmb	頪
rbbb	頫
rbbt	頫
rta	頫
rtmb	頫
bda	頭
bdn	頭
dta	頭
dtmb	頭
wrtb	頮
wrt	頮
ertb	頯
ert	頯
urtb	頯
urt	頯
gta	頰
gtmb	頰
eatb	頱
eat	頱
uatb	頱
uat	頱
kwtb	頲
kwt	頲
yftb	頳
yft	頳
frsb	頴
frst	頴
trsb	頴
trst	頴
yrst	頴
eotb	頵
eot	頵
sotb	頶
sot	頶
ayob	頷
ayot	頷
esib	頸
esit	頸
et	頸
sitb	頸
sit	頸
uitb	頸
uit	頸
uytb	頸
uyt	頸
hrtb	頹
hrt	頹
ht	頹
hrtb	頺
hrt	頺
zstb	頻
zst	頻
jcsb	頼
jcst	頼
vstb	頼
vst	頼
hrtb	頽
hrt	頽
mzfb	頿
mzft	頿
vta	顀
vtmb	顀
nezb	顁
nezt	顁
nztb	顁
nzt	顁
fftb	顃
fft	顃
wbbb	顄
wutb	顄
wut	顄
futb	顅
fut	顅
qttb	顆
qtt	顆
jjtb	顇
jjt	顇
fstb	顈
fst	顈
ata	顉
atmb	顉
pbjb	顊
pbjt	顊
qhtb	顋
qht	顋
dezb	題
dezt	題
dt	題
jta	題
jtmb	題
npob	額
npot	額
nt	額
oorb	顎
oort	顎
ota	顎
otmb	顎
llmb	顏
llmt	顏
lpmb	顏
lpmt	顏
wb	顏
wlmb	顏
wlmt	顏
nctb	顐
nct	顐
aqpb	顑
aqpt	顑
aqvb	顑
aqvt	顑
kta	顑
ktmb	顑
qnub	顒
qnut	顒
dta	顓
dtmb	顓
ertb	顓
ert	顓
etnb	顓
etnt	顓
llmb	顔
llmt	顔
lpmb	顔
lpmt	顔
wb	顔
dfeb	顕
dfet	顕
poxb	顖
poxt	顖
pta	顖
ptmb	顖
edtb	顗
edt	顗
lpdb	願
lpdt	願
yta	願
ytmb	願
yt	願
uuub	顙
uuut	顙
jbtb	顛
jbt	顛
jbv	顛
jmeb	顛
jmet	顛
jmlb	顛
jmlt	顛
jnyb	顜
jnyt	顜
jta	顜
jtmb	顜
qutb	顝
qut	顝
madb	類
madt	類
mad	類
mb	類
mdn	類
eebb	顟
eebt	顟
emtb	顟
emt	顟
crsb	顠
crst	顠
rnbb	顢
rnbt	顢
aqpb	顣
aqpt	顣
yrtb	顤
yrt	顤
yyyb	顤
yyyt	顤
dlob	顥
dlot	顥
dlsb	顥
dlst	顥
vftb	顦
vft	顦
fb	顧
fvtb	顧
fvt	顧
lptb	顧
lpt	顧
tmbr	顨
ttr	顨
aoob	顩
aoot	顩
ata	顩
atmb	顩
ota	顩
otmb	顩
zaqb	顪
zaqt	顪
zta	顪
ztmb	顪
loob	顫
loot	顫
urtb	顬
urt	顬
utnb	顬
utnt	顬
rfnb	顭
rfnt	顭
nsmb	顮
nsmt	顮
db	顯
dfeb	顯
dfet	顯
dfe	顯
dwwb	顯
dwwt	顯
zstg	顰
zqfb	顱
zqft	顱
fflb	顲
fflt	顲
rrrb	顳
rrrt	顳
roob	顴
root	顴
rta	顴
rtmb	顴
rca	風
rxx	風
rcm	颩
rcx	颬
rcy	颬
rczo	颭
rcnl	颮
rcn	颮
lrc	颯
lrx	颯
rcuo	颱
rxuo	颱
rcdr	颲
rcgo	颳
rcsu	颵
rcmb	颶
rxmb	颶
rcff	颷
rcqh	颸
rcws	颹
rcw	颹
rcdm	颺
rce	颺
ewuc	颻
unc	颻
uurc	颻
uwuc	颻
rcgu	颼
rxgu	颼
edrc	颽
rcuc	颾
mfrc	颿
rcdq	飀
rcoq	飀
rxdq	飀
rxoq	飀
eepc	飁
rcem	飂
rccs	飃
ccv	飄
crsc	飄
crsx	飄
adac	飆
adax	飆
fffc	飆
fffx	飆
rcad	飆
rcff	飆
rxad	飆
rxff	飆
rcad	飇
rcff	飈
rcds	飉
rcl	飉
fffc	飊
rckh	飋
rckx	飋
rooc	飌
rrc	飌
rcrc	飍
fj	飛
lba	飛
zba	飛
mqf	飜
fff	飝
xn	食
bxn	飡
xrl	飢
xrz	飢
xti	飣
xgl	飥
xgj	飦
cxn	飧
dxn	飧
xel	飩
xke	飪
xgn	飫
xpd	飫
bnak	飬
bna	飬
bnek	飬
xvd	飭
xlu	飯
xja	飰
xlp	飰
dxn	飱
xin	飲
xak	飳
xuo	飴
xvf	飵
xhp	飶
xme	飷
okx	飸
xdp	飹
zfx	飺
xeo	飼
xyeo	飼
xnl	飽
xnol	飽
xvn	飾
xee	飿
xeu	飿
xrx	餀
xpk	餁
xgo	餂
xlx	餃
xbk	餅
xra	餆
xrbb	餆
xneo	餇
bix	餈
rix	餈
xov	餉
xpno	餉
bhna	養
bhnk	養
bhnr	養
bkbr	養
bkx	養
kx	養
xrj	餌
zca	餐
zcux	餐
zcx	餐
zn	餐
xjnz	餑
xeg	餒
xix	餓
xajq	餔
xij	餔
xhx	餕
xubp	餕
xurp	餕
xde	餖
xjcs	餗
xvs	餗
atn	餘
bhn	餘
xat	餘
xbh	餘
xxxn	餙
xxxu	餚
xxx	餚
xdb	餛
xqt	餜
xrf	餝
xaf	餞
xaqq	餞
xkx	餞
xuuu	餟
xbgg	餠
xbk	餠
xpgg	餠
xdg	餡
xeg	餡
xng	餡
xlo	餢
xdil	餣
xdql	餣
xxl	餣
xff	餤
rssx	餥
xhg	餧
bgob	館
bnb	館
xnb	館
xblh	餩
xrd	餪
xtnd	餪
xnc	餫
xfu	餬
xjou	餬
xpdk	餭
cbmx	餮
dbmx	餮
xceq	餯
xmii	餰
xmit	餰
xpfd	餱
xdl	餲
xdnl	餲
xdem	餳
xdvm	餳
xep	餳
xqk	餵
xqu	餶
xleo	餹
xaja	餺
xia	餺
xbkf	餻
xkm	餼
xpqu	餽
xpru	餽
xva	餽
xddq	餾
xoq	餾
xgiu	餿
xgu	餿
xeg	饀
xce	饁
xyuf	饁
xrdd	饃
xsny	饄
xdfu	饅
xmx	饅
xfoo	饇
xbhe	饈
xbke	饈
xrc	饉
xceb	饋
xqa	饋
xflb	饌
xolb	饌
xbho	饍
xbko	饍
xydo	饎
xyoo	饎
irpx	饏
trpx	饏
xynd	饐
xwb	饑
xwwb	饑
xqer	饒
xyr	饒
xyyr	饒
xsnt	饓
lwvx	饔
okzx	饕
oxn	饕
xec	饖
xzas	饖
wabx	饗
wadx	饗
wxn	饗
xxn	饗
xloe	饘
xlom	饘
xja	饙
xjrb	饙
xrc	饚
xryf	饚
xrnq	饛
ladx	饜
ldux	饜
yxn	饜
xlto	饝
xeb	饞
xncb	饞
xnoa	饞
xnoe	饞
xln	饟
xlok	饟
xsrb	饡
btm	首
ho	首
kbtm	馗
kho	馗
btme	馘
btmh	馘
haqe	馘
hhe	馘
hdo	香
hdbd	馚
hdcf	馜
hdhp	馝
hdjz	馞
hdao	馠
hdrs	馡
hdaq	馢
hdk	馢
hddl	馣
hdx	馣
hddl	馤
hdd	馤
hdvp	馥
hdv	馥
hdq	馦
hddf	馧
hdof	馧
ycrd	馨
yhd	馨
hdjb	馩
hdj	馩
hdnb	馪
hdhd	馫
mfa	馬
mfu	馭
bmf	馮
mfg	馯
mfna	馰
mfd	馱
mfg	馲
mav	馳
mfa	馳
mfs	馴
mfr	馵
mfju	馶
mfjn	馷
mfln	馷
mfk	馸
mfd	馹
mfpu	馺
mfrn	馺
mfur	馻
mfw	馼
mfc	馽
mfk	馾
mfnr	馾
mff	馿
mfak	駀
mfxx	駁
cjmf	駂
fjmf	駂
mfj	駃
mfda	駄
mfp	駇
mfke	駈
mfpo	駈
mfno	駉
mfp	駊
mfdo	駋
cpmf	駌
mfp	駍
mfiq	駎
mfff	駏
ak	駐
mfak	駐
mkv	駐
gumf	駑
mfno	駒
mfbe	駓
mfm	駔
dfv	駕
domf	駕
mfap	駖
mfat	駖
mfbm	駗
mfuo	駘
mfpa	駙
mfc	駚
mfc	駛
mfhp	駜
mfnf	駝
mfva	駞
mff	駟
mfdp	駠
fmf	駡
oomf	駡
mfbk	駢
mfrb	駣
mfr	駣
mfp	駤
mfaj	駥
mfax	駥
bnmf	駦
mfno	駧
mfnd	駨
mfbk	駩
mfsr	駪
mfsr	駫
mfr	駬
mflh	駭
mflx	駮
mfsb	駯
mfss	駯
mfod	駰
mfpo	駱
mfpw	駳
mfar	駴
mfef	駵
mfeo	駵
mfo	駵
mfx	駵
mfyf	駵
mfco	駶
mfjs	駷
mfvs	駷
mfeu	駸
mfr	駸
mfam	駹
mfak	駺
mfa	駺
mfdg	駻
mfbh	駼
mfou	駽
mfbr	駾
mfh	駿
mfup	駿
mfi	騀
mfik	騁
mfqk	騁
mfl	騂
mfa	騃
mfud	騃
mfcw	騄
mfv	騅
mfno	騆
mfn	騆
mfbo	騇
mfbg	騈
mfbk	騈
mfpg	騈
mfpk	騈
mfdb	騉
mfne	騊
mfnu	騊
mfn	騊
mfl	騋
mfns	騌
mfqt	騍
mfdo	騎
mfv	騎
mfkb	騏
mfah	騐
mfrs	騑
mfdb	騔
mfdl	騔
mfd	騔
mfcg	騕
mfv	騕
mpmf	騖
fmmf	騗
mfnh	騘
mffm	騙
mfbr	騚
mfb	騚
mff	騛
mfpk	騜
mfew	騝
mffo	騞
mfar	騟
mfa	騟
mfdz	騠
mfj	騠
mfpw	騡
mfou	騢
mfo	騢
mfxp	騣
mfjd	騤
mfk	騤
mfmt	騥
mfqh	騦
mfqo	騧
mfpu	騩
mfv	騩
mfgu	騪
njmf	騫
mfgs	騬
bzsf	騭
mfdq	騮
mfoq	騮
mfg	騯
mflf	騯
ubnf	騰
mfed	騱
mfrj	騲
mfdg	騴
mfls	騵
mfy	騵
mfne	騶
mcv	騷
mfuc	騷
mffe	騸
mfrc	騹
jzmf	騺
ybgf	騺
yzmf	騺
mfdx	騻
mfjb	騻
mflb	騼
mfed	騽
mfqs	騾
mflj	騿
rddf	驀
hnpf	驁
yfpf	驁
mfum	驂
mfcs	驃
mfbh	驄
mfph	驄
mfp	驄
mffo	驅
mffx	驅
mxv	驅
mfqq	驆
mfq	驆
mfmo	驈
mfze	驉
mfa	驊
mfpj	驊
mfrq	驊
mfeh	驌
mfqr	驍
mfyr	驍
mfmc	驎
mfms	驎
mfcz	驏
mflp	驐
mfeq	驑
mfoq	驑
mfxq	驑
mfyq	驑
mfoj	驒
mfo	驒
mfbd	驓
mfb	驓
mfcj	驔
mfx	驔
mfeo	驕
mfgo	驕
mfgr	驕
mfg	驕
mfpo	驕
mfjk	驖
mfyq	驖
mfab	驗
mfac	驗
mfae	驗
mfar	驗
mfa	驗
mfo	驗
fuma	驘
fumx	驘
fumz	驘
mfle	驙
mflm	驙
hlos	驚
hls	驚
nmf	驚
rnof	驚
mfcn	驛
mffg	驛
mffy	驛
mfuq	驛
mffl	驜
mffs	驜
mfft	驜
mfnb	驞
mfrb	驟
mfrk	驟
mfrq	驟
mq	驟
mfrf	驠
amf	驡
lulf	驡
mff	驢
mfzc	驢
mfzf	驢
mfbf	驣
mflk	驤
mfl	驤
mffb	驥
mfum	驦
mfrm	驧
mfeo	驨
mfrv	驩
mfr	驩
mflb	驪
mfl	驪
mfmf	驫
que	骨
quk	骩
quz	骫
qug	骭
qulr	骯
ulr	骯
quru	骰
qubr	骱
qup	骳
quzf	骴
qute	骵
quxe	骶
qujo	骷
qulh	骸
qulx	骹
qudk	骻
qux	骻
qupo	骼
queg	骽
qutx	骾
qut	骾
qubk	骿
qupg	髀
quqt	髁
quno	髂
quxw	髄
quaa	髆
quia	髆
qulo	髇
quq	髇
qug	髈
qulf	髈
qunv	髉
qubi	髊
qult	髍
quem	髎
qumg	髏
quyr	髐
qufc	髑
qrv	髒
qurr	髒
uly	髒
quxw	髓
qux	髓
qwv	髓
pte	體
qd	體
qufd	體
qurd	體
qunb	髕
quna	髖
quzf	髗
lhno	高
lno	高
lono	高
q	高
lhnr	髚
lnor	髚
lonr	髚
qlr	髚
lhnx	髜
lnox	髜
lonx	髜
qdx	髜
lhnd	髝
lnod	髝
lond	髝
qffd	髝
qrnd	髝
lhnt	髞
lnot	髞
lont	髞
qlt	髞
qoot	髞
vp	髟
vrl	髠
vrz	髠
ver	髡
val	髢
vfy	髣
vtn	髤
vnr	髥
vue	髥
vml	髦
vkl	髧
vrr	髨
vfk	髩
vtly	髩
vaxu	髪
vax	髪
vxu	髪
vdo	髫
vbe	髬
vzf	髭
axu	髮
vaxx	髮
vax	髮
vny	髯
vnl	髱
vnol	髱
vpx	髲
vmp	髳
vvj	髴
vri	髵
vtnr	髵
vrj	髶
vfo	髷
vror	髷
vrb	髸
vpt	髹
vgo	髺
vyo	髻
vpf	髼
vbby	髽
vsu	髾
vbqp	鬀
vtp	鬀
vhr	鬁
vkeb	鬂
vpob	鬂
vnrs	鬃
vns	鬃
vdnm	鬄
vep	鬄
vuu	鬅
vtbu	鬆
vu	鬆
vee	鬇
vne	鬇
vbnl	鬈
vbnp	鬈
vpl	鬈
vxup	鬉
vfnd	鬊
vber	鬋
vbi	鬋
vxiu	鬌
vfu	鬍
vjou	鬍
vjcr	鬎
vvsr	鬎
vho	鬐
vypd	鬐
vqn	鬑
vfmb	鬒
vjb	鬒
vjmb	鬒
vpfw	鬔
vrdd	鬕
vudm	鬖
vum	鬖
vuum	鬖
vma	鬗
vrnb	鬗
vdfu	鬘
vmx	鬘
vbo	鬙
vbqd	鬙
vmtb	鬚
vmt	鬚
vffk	鬞
vnk	鬞
vrok	鬞
vfek	鬟
von	鬟
vad	鬠
vaqd	鬠
vnht	鬡
vbv	鬢
vncb	鬢
vnkb	鬢
vnpb	鬢
vnsb	鬢
vsfs	鬣
vsl	鬣
vsos	鬣
vln	鬤
vlok	鬤
dda	鬥
di	鬥
mda	鬥
ddj	鬦
dln	鬧
drb	鬨
dgr	鬩
dda	鬪
dirp	鬫
dtrp	鬫
dok	鬬
dook	鬬
dork	鬬
dnx	鬮
xfuf	鬯
txxm	鬰
twum	鬱
txxm	鬱
eont	鬲
zeot	鬳
eoni	鬴
eonq	鬴
kket	鬵
eonp	鬷
eonq	鬸
eone	鬺
eonm	鬺
qmqt	鬻
pqru	鬼
pru	鬼
va	鬼
pqrm	鬽
prum	鬽
vmp	鬽
pqru	鬾
pruu	鬾
vju	鬾
pqrk	鬿
pruk	鬿
vki	鬿
pqrr	魀
prur	魀
vbr	魀
pqrd	魁
prud	魁
vdj	魁
tpqu	魂
tpru	魂
tva	魂
pqrx	魃
prua	魃
pruu	魃
prux	魃
vaxx	魃
vax	魃
pdpu	魄
pdv	魄
pqrb	魅
pqrs	魅
pqrt	魅
prub	魅
prus	魅
vqb	魅
vys	魅
pqri	魆
prui	魆
vaqi	魆
pqru	魈
pruu	魈
vsu	魈
pqrb	魉
prub	魉
veb	魉
venb	魉
pqre	魊
pqrh	魊
prue	魊
pruh	魊
vaqe	魊
vhe	魊
pqrv	魋
pruv	魋
vve	魋
pqrb	魌
prub	魌
vkb	魌
pqrf	魍
pruf	魍
vnbf	魍
pqrb	魎
prub	魎
veb	魎
venb	魎
vtnb	魎
hgpu	魏
hgv	魏
pqrf	魐
pquq	魐
pruf	魐
pruq	魐
vbef	魐
vqn	魐
pqrl	魑
pqru	魑
prul	魑
pruu	魑
vla	魑
vlxu	魑
vwuu	魑
pqrs	魒
prus	魒
vcrs	魒
vqjq	魓
vqj	魓
vqrj	魓
lttu	魔
lttv	魔
lvv	魔
pqrb	魕
prub	魕
vwb	魕
vwwb	魕
pqre	魖
prue	魖
vzfe	魖
fapu	魗
fav	魗
yyiu	魗
yyiv	魗
ladv	魘
lduu	魘
lduv	魘
yva	魘
wcku	魙
wckv	魙
ufa	魚
ufd	魛
ufr	魝
ufi	魟
ufg	魠
ufna	魡
ufu	魣
ufpf	魤
ufs	魦
uflr	魧
ufe	魨
ufnm	魩
ufk	魫
ufnr	魫
uflu	魬
ufd	魯
ufw	魰
ufde	魱
uff	魲
uff	魴
ufbd	魵
ufnb	魶
ufak	魷
ufto	魺
ufqi	魻
ufyu	魼
ufgr	魽
ufg	魽
ufbe	魾
ufnf	鮀
ufob	鮂
ufp	鮃
ufv	鮄
ufhp	鮅
zfuf	鮆
ufqb	鮇
ufys	鮇
ufno	鮈
ufdo	鮉
ufiq	鮋
uflw	鮌
ufzo	鮎
ufs	鮏
ufuo	鮐
ufnl	鮑
ufn	鮑
ufpa	鮒
ufvf	鮓
ufff	鮔
ufjo	鮕
ufee	鮙
ufyo	鮚
uffs	鮛
bnuf	鮝
ufr	鮞
uftr	鮞
ufng	鮟
ufnp	鮠
ufrb	鮡
ufr	鮡
ufsb	鮢
ufss	鮢
ufep	鮣
druf	鮤
ufpo	鮥
ufno	鮦
uffd	鮨
ufxu	鮪
ufx	鮪
uflx	鮫
ufyy	鮭
ufbh	鮮
uhv	鮮
uq	鮮
ufao	鮯
ufbr	鮵
ufeo	鮶
ufe	鮸
ufnr	鮸
ufsu	鮹
ufh	鮻
ufup	鮻
ufat	鮽
ufbh	鮽
ufrl	鮿
ufes	鯀
ufps	鯀
uftx	鯁
uft	鯁
ufe	鯂
ufwo	鯃
ufaw	鯄
ufn	鯄
ufpw	鯅
ufaq	鯆
ufi	鯆
ufnr	鯇
pipf	鯈
ufq	鯉
wsuf	鯊
ufws	鯋
ufso	鯌
ufts	鯍
ufs	鯓
ufsq	鯔
ufkb	鯕
ufhu	鯖
bkbf	鯗
uflz	鯙
ufhz	鯚
ufno	鯛
ufnr	鯛
ufn	鯛
uflg	鯜
ufen	鯞
ufe	鯞
ufcs	鯟
ufjs	鯟
ufl	鯠
ufrs	鯡
ufgr	鯢
ufdm	鯣
ufe	鯣
ufdb	鯤
ufyy	鯥
ufy	鯥
ufpo	鯦
ufdd	鯧
ufls	鯨
ufam	鯩
ufyp	鯪
ufy	鯪
ufru	鯫
hduf	鯬
ufns	鯮
ufah	鯰
ufnc	鯶
ufdz	鯷
ufj	鯷
ufpd	鯸
ufds	鯹
ufjr	鯻
ufvr	鯻
ufxp	鯼
ufdp	鯽
ufg	鯽
ufpt	鯾
ufpx	鯾
uffm	鯿
ufep	鰀
ufeu	鰀
ufe	鰀
ufmr	鰂
ufag	鰄
ufqu	鰅
uffd	鰆
ufmt	鰇
ufst	鰈
ufpk	鰉
ufcs	鰊
ufjs	鰊
uffg	鰋
ufbe	鰌
ufhf	鰍
ufew	鰎
ufok	鰐
ufo	鰐
ufvp	鰒
ufv	鰒
ufqh	鰓
ufao	鰔
ufk	鰔
ufou	鰕
ufo	鰕
ufju	鰗
ufbf	鰜
ufq	鰜
uflo	鰝
ufq	鰝
ufg	鰟
uflf	鰟
ufdq	鰡
ufoq	鰡
ufda	鰣
ufpn	鰤
uffb	鰥
uffq	鰥
uffw	鰥
ufde	鰨
ufee	鰩
ufeu	鰩
ufue	鰩
ufuu	鰩
ufno	鰫
ufnw	鰫
ufzp	鰬
ufzw	鰬
ufyd	鰭
ufcw	鰱
hnpf	鰲
yfpf	鰲
ufrd	鰳
miep	鰴
miup	鰴
vomf	鰵
vuf	鰵
ufjs	鰶
ufj	鰶
ufpt	鰷
ufp	鰷
uffo	鰸
ufox	鰸
ufry	鰹
ufum	鰺
ufdu	鰻
ufm	鰻
ufed	鰼
ufrd	鰽
ufcs	鰾
ufhb	鰿
duf	鱀
dukf	鱀
ufew	鱁
ufca	鱄
ufja	鱄
ufqa	鱄
ufx	鱄
uflq	鱅
uflj	鱆
ufue	鱈
buf	鱉
snsf	鱉
ufmo	鱊
ufze	鱋
ufnq	鱌
ufn	鱌
uff	鱍
ufju	鱍
ufgo	鱎
ufg	鱎
ufcj	鱏
ufx	鱏
ufeh	鱐
ufk	鱑
ufrb	鱑
ufba	鱒
ufoj	鱓
ufo	鱓
ufbo	鱔
ufmq	鱕
ufli	鱖
ufmc	鱗
ufms	鱗
ufea	鱘
ufyr	鱙
ufjb	鱝
ufj	鱝
uffk	鱞
ufo	鱞
snuf	鱟
ufad	鱠
ufmj	鱡
ufmx	鱡
uflt	鱢
ufot	鱢
ufle	鱣
uflm	鱣
ufzs	鱥
ufx	鱦
uffd	鱧
ufrd	鱧
ufsd	鱨
ufur	鱬
ufwh	鱭
ufe	鱮
ufru	鱯
uflu	鱱
ufpt	鱳
ufr	鱳
ufwt	鱳
ufra	鱴
ufrb	鱴
ufre	鱴
ufrv	鱴
ufzk	鱵
ufzo	鱵
ufbx	鱶
ufko	鱷
ufo	鱷
ufte	鱷
uftl	鱷
ufzc	鱸
ufzf	鱸
ufrv	鱹
ufr	鱹
uflb	鱺
ufuf	鱻
nfa	鳥
nfz	鳦
nfr	鳧
nfd	鳨
knf	鳩
pnf	鳪
lnf	鳫
nrl	鳬
nrz	鳬
dnf	鳭
unf	鳮
rnf	鳯
gnf	鳱
cnf	鳲
renf	鳳
rnf	鳳
rux	鳳
onf	鳴
ranf	鳵
zjnf	鳵
znf	鳵
axnf	鳶
junf	鳷
fnf	鳸
aynf	鳹
qanf	鳺
qnnf	鳺
bdnf	鳻
wnf	鳼
knf	鳽
ennf	鳾
tnnf	鳾
knf	鳿
bnf	鴀
gnnf	鴁
pdnf	鴁
jnf	鴂
nfj	鴃
frnf	鴄
naef	鴅
nlnf	鴅
knf	鴆
cjnf	鴇
fjnf	鴇
lpnf	鴈
xnf	鴉
ynf	鴉
eznf	鴊
ednf	鴌
gnnf	鴌
wnf	鴍
nfpx	鴏
donf	鴐
apnf	鴒
atnf	鴒
hpnf	鴓
bznf	鴔
pazf	鴔
pznf	鴔
nfnf	鴕
oxnf	鴖
lnf	鴗
urnf	鴘
vdnf	鴙
nfto	鴚
cpnf	鴛
nonf	鴝
oknf	鴞
xenf	鴟
denf	鴠
mnf	鴡
wdnf	鴢
jonf	鴣
nfpb	鴤
nfnb	鴥
cnf	鴦
nrnf	鴧
qinf	鴨
snnf	鴩
nbnf	鴪
pbnf	鴭
drkf	鴮
xnf	鴮
rnf	鴯
tnrf	鴯
gonf	鴰
rxnf	鴱
ngnf	鴳
rbbf	鴵
rnf	鴵
yonf	鴶
drnf	鴷
sbnf	鴸
ssnf	鴸
bhnf	鴹
winf	鴻
gonf	鴽
usnf	鴾
aonf	鴿
pknf	鵀
lxnf	鵁
ptnf	鵂
znf	鵃
pnf	鵄
ponf	鵅
gnf	鵊
flhf	鵋
nfbh	鵌
nrrf	鵍
egnf	鵎
ajnf	鵏
inf	鵏
wnf	鵐
ounf	鵑
bbof	鵒
wnf	鵒
jnzf	鵓
nfh	鵔
nfup	鵔
hnf	鵕
ubpf	鵕
urpf	鵕
pdcf	鵖
pdff	鵖
xxnf	鵗
eonf	鵘
mbnf	鵙
hrnf	鵚
esif	鵛
sinf	鵛
uinf	鵛
uynf	鵛
bqif	鵜
bqpf	鵜
tnf	鵜
inf	鵝
inf	鵞
qknf	鵟
sonf	鵠
eaxf	鵡
wnf	鵡
jcsf	鵣
vsnf	鵣
nfcw	鵦
nfew	鵦
bknf	鵧
bgof	鵨
bnf	鵨
upuf	鵩
diqf	鵪
dqlf	鵪
xnf	鵪
qnf	鵫
zdjf	鵫
uunf	鵬
anf	鵭
ngnf	鵮
pgnf	鵯
pqgf	鵯
nnf	鵰
nyof	鵰
ybyf	鵱
ynf	鵱
yryf	鵱
rdnf	鵲
funf	鵳
nmnf	鵴
dcrf	鵵
eanf	鵵
ncrf	鵵
onf	鵶
ncpf	鵷
dtof	鵸
vnf	鵸
hdnf	鵹
lnf	鵺
lpuf	鵺
nfv	鵻
uuuf	鵽
dbnf	鵾
nfdx	鵿
nfkb	鶀
losf	鶁
lsnf	鶁
grnf	鶂
nfgr	鶃
hunf	鶄
sqnf	鶅
lnf	鶆
csnf	鶇
jqsf	鶇
jegf	鶈
jgnf	鶈
lhzf	鶉
lozf	鶉
lznf	鶉
lebf	鶊
lenf	鶊
cjof	鶋
ceef	鶌
ceuf	鶌
atwf	鶐
jcsf	鶒
vsdf	鶒
mtnf	鶔
ldnf	鶕
hfnf	鶖
dezf	鶗
jnf	鶗
jouf	鶘
lnnf	鶙
onf	鶚
oorf	鶚
bpdf	鶛
rmnf	鶜
eoqf	鶝
kmnf	鶞
xmnf	鶞
nbaf	鶟
nraf	鶟
fdgf	鶠
dnbf	鶡
dnf	鶡
eguf	鶢
enf	鶢
fmnf	鶣
ncnf	鶤
cmnf	鶥
jouf	鶦
rcnf	鶧
ceqf	鶨
mpnf	鶩
madf	鶪
adof	鶬
bpnf	鶬
sfnf	鶭
lhnf	鶮
lnof	鶮
lonf	鶮
qnf	鶮
ffnf	鶯
rnnf	鶯
ombf	鶰
njnf	鶱
buef	鶲
nfpn	鶳
nvnf	鶴
nenf	鶵
leof	鶶
nfof	鶷
nhof	鶷
qbqf	鶸
qmqf	鶸
ddqf	鶹
oqnf	鶹
bbbf	鶺
rbrf	鶺
wbuf	鶺
wnuf	鶺
qunf	鶻
qnf	鶼
vjnf	鶽
jbnf	鶾
jdjf	鶾
bewf	鶿
rwwf	鶿
bebf	鷁
ynf	鷁
ewuf	鷂
uunf	鷂
uwuf	鷂
dngf	鷃
ewdf	鷄
ctnf	鷅
yneu	鷇
ynnu	鷇
nflr	鷈
eonf	鷊
ratf	鷋
rbhf	鷋
nfmf	鷌
pmtf	鷍
pddf	鷎
pdtf	鷎
jbnf	鷏
jmef	鷏
jmlf	鷏
dfkf	鷐
zlnf	鷑
cuaf	鷒
jquf	鷒
xnf	鷒
lrff	鷓
ovnf	鷕
fvdf	鷖
foof	鷗
fxnf	鷗
jcsf	鷘
vspf	鷘
jznf	鷙
ybgf	鷙
yznf	鷙
eebf	鷚
emnf	鷚
lenf	鷛
mgnf	鷜
qjjf	鷝
qnf	鷝
qrjf	鷝
dxxf	鷞
jxxf	鷞
fvvf	鷟
eknf	鷡
glnf	鷡
vfff	鷡
lbef	鷢
cdjf	鷣
xnf	鷣
onf	鷤
ooqf	鷤
ssnf	鷥
wwef	鷥
vfnf	鷦
anf	鷨
rjjf	鷨
rrjf	鷨
bnf	鷩
snsf	鷩
ehnf	鷫
knf	鷬
reqf	鷬
mqnf	鷭
edof	鷮
gnf	鷮
gnof	鷮
pdof	鷮
dbdf	鷯
lnf	鷯
rfof	鷰
roff	鷰
gnf	鷲
losf	鷲
lsaf	鷲
munf	鷳
mtnf	鷴
chnf	鷵
cypf	鷵
fmbf	鷶
mnf	鷶
beaf	鷷
mnbf	鷸
mnrf	鷸
lpvf	鷹
lnf	鷺
ozpf	鷺
nflp	鷻
snnf	鷽
ldhf	鷾
colf	鷿
pnf	鷿
fncf	鸀
foua	鸁
fouz	鸁
funa	鸁
funz	鸁
wewf	鸂
nfbi	鸃
nfb	鸃
pdff	鸄
fybf	鸅
fynf	鸅
zogf	鸆
zokf	鸆
loof	鸇
febf	鸈
fsnf	鸈
tdef	鸉
tenf	鸉
nhff	鸋
ntnf	鸋
rnf	鸍
mbmf	鸎
snf	鸎
rnrf	鸏
eevf	鸐
qiaf	鸑
enf	鸒
qqqf	鸓
nfdw	鸔
zqff	鸕
uvnf	鸖
anf	鸗
lulf	鸗
utmf	鸘
aoof	鸙
mbmf	鸚
sgnf	鸚
rnf	鸛
roof	鸛
mmvf	鸜
llbf	鸝
issf	鸞
lff	鸞
lfnf	鸞
sisf	鸞
zoxa	鹵
zoxf	鹵
zoxk	鹹
zoxo	鹹
zoxi	鹺
zoxf	鹻
zoxq	鹻
zoxb	鹼
zoxo	鹼
rvzf	鹽
rzof	鹽
yfv	鹽
ypf	鹽
yvof	鹽
lbl	鹿
lbf	麀
nfb	麁
nlb	麁
nlrb	麁
nrfb	麁
lbr	麂
lbf	麃
bdlb	麄
lbnl	麅
lbn	麅
lbm	麆
lbh	麇
lbak	麈
gglb	麉
mlb	麊
lbm	麋
lbod	麌
lbts	麍
lbfk	麎
lbwo	麐
lbgr	麑
lbkb	麒
ttlb	麓
lbpo	麔
lboh	麕
la	麗
llb	麗
lbhd	麘
lbao	麙
lbk	麙
lbou	麚
lbo	麚
lbqr	麛
lbct	麜
lbsa	麝
lblj	麞
lbmc	麟
lbms	麟
lbee	麠
lbwh	麡
lbuo	麢
lbop	麣
lbo	麣
lblb	麤
gca	麥
gpx	麥
hpx	麥
lca	麥
lpx	麥
fux	麦
hpx	麦
gcvz	麧
gpvz	麧
lcvz	麧
lpvz	麧
gcqn	麩
gpqn	麩
lcqn	麩
lpqn	麩
gcty	麪
gpty	麪
lcty	麪
lpty	麪
gcfk	麫
gpfk	麫
lcfk	麫
lpfk	麫
gcp	麬
gpp	麬
lcp	麬
lpp	麬
gcnl	麭
gcn	麭
gpnl	麭
gpn	麭
lcnl	麭
lcn	麭
lpnl	麭
lpn	麭
gcyu	麮
gpyu	麮
lcyu	麮
lpyu	麮
gcf	麯
gcro	麯
gcrr	麯
gpf	麯
gpro	麯
gprr	麯
lcf	麯
lcro	麯
lcrr	麯
lpf	麯
lpro	麯
lprr	麯
gcus	麰
gpus	麰
lcus	麰
lpus	麰
gcaq	麱
gci	麱
gpaq	麱
gpi	麱
lcaq	麱
lci	麱
lpaq	麱
lpi	麱
gcmr	麲
gpmr	麲
lcmr	麲
lpmr	麲
gcnm	麴
gpnm	麴
lcnm	麴
lpnm	麴
gcth	麵
gcto	麵
gcty	麵
gpth	麵
gpto	麵
gpty	麵
hg	麵
lcth	麵
lcto	麵
lcty	麵
lpth	麵
lpto	麵
lpty	麵
toh	麵
bplu	麶
gclu	麶
gcl	麶
gcwu	麶
gplu	麶
gpl	麶
gpwu	麶
lclu	麶
lcl	麶
lcwu	麶
lplu	麶
lpl	麶
lpwu	麶
gcfd	麷
gpfd	麷
lcfd	麷
lpfd	麷
ltt	麻
lpu	麼
lttu	麼
lttw	麼
lw	麼
pua	麼
lttu	麽
lttw	麽
lttm	麾
lttu	黀
lttd	黁
lttb	黂
ka	黃
reqb	黃
riqb	黃
rqb	黃
rtqb	黃
ka	黄
rqb	黄
kay	黅
reqy	黅
rtqy	黅
kkl	黆
knr	黆
reqk	黆
reqr	黆
kak	黈
reqk	黈
kyy	黊
reqy	黊
rtqy	黊
snk	黌
snrb	黌
hbw	黍
hdbw	黎
hw	黎
hbwo	黏
hbwl	黐
hbwu	黐
qfa	黑
qfa	黒
qaxf	黓
qfax	黓
qfay	黔
qfk	黕
qfnr	黕
qfk	黖
qfe	黗
qadf	默
qfad	默
qf	默
qfg	黚
paxf	黛
qfee	黜
qfeu	黜
qfwd	黝
ao	點
qfzo	點
qzof	點
zod	點
zof	點
qfcc	黟
qfyo	黠
qyof	黠
qfvm	黣
qfdl	黤
qfx	黤
qfls	黥
qfnp	黦
hdqf	黧
sf	黨
snof	黨
qfcy	黫
qfar	黭
qfkb	黮
qfkl	黮
qfkr	黮
qfk	黮
qfld	黯
qfjb	黰
ubnf	黱
qfum	黲
fvdf	黳
miep	黴
miqp	黴
qfni	黵
qfv	黵
lduf	黶
yqf	黶
qfyb	黷
qfym	黷
febs	黹
fess	黹
fra	黹
febd	黺
fesd	黺
frbd	黺
faqs	黻
feba	黻
febq	黻
febx	黻
fesx	黻
frax	黻
fra	黻
febi	黼
fesi	黼
fesq	黼
fraq	黼
friq	黼
fri	黼
xl	黽
oiql	黾
oql	黾
xl	黾
rrx	黿
yrx	鼀
yux	鼁
dex	鼂
yyx	鼃
sbx	鼄
ssx	鼄
vdox	鼅
ndlx	鼆
hnpx	鼇
yfpx	鼇
bxl	鼈
snsx	鼈
ooqx	鼉
colx	鼊
pxl	鼊
mdi	鼎
mdy	鼎
nmd	鼏
rmd	鼐
umd	鼒
ydju	鼓
ydzu	鼓
yobu	鼓
yuv	鼓
ydzu	鼔
ydjb	鼕
yobb	鼕
jryu	鼖
rbbu	鼗
rydu	鼗
ydjh	鼘
yobh	鼘
ydjg	鼙
yobg	鼙
ydjk	鼚
yobk	鼚
ydjo	鼛
yobo	鼛
ydjc	鼜
yobc	鼜
whyu	鼝
ydjy	鼞
yoby	鼞
gsl	鼠
gsn	鼠
gsbd	鼢
gsad	鼣
gsw	鼤
gsax	鼥
gsa	鼥
gsdo	鼦
gsnf	鼧
gspb	鼨
gsno	鼩
gss	鼪
gslo	鼫
gsiq	鼬
gsya	鼭
gskw	鼮
gswo	鼯
gsmb	鼰
gshu	鼱
gsnc	鼲
gsmd	鼳
gsfg	鼴
gsnd	鼵
gslr	鼶
gsed	鼷
gsq	鼸
gsdg	鼹
pmqr	鼻
pmqk	鼽
pmqg	鼾
pmqw	齀
pmqo	齁
pmqw	齂
pmqb	齃
pmqd	齃
pmql	齃
pmqd	齅
pmqc	齆
pmql	齆
pmqm	齇
pmqk	齈
pmqk	齉
whe	齊
wri	齊
whs	齋
wri	齋
wrrs	齋
wrs	齋
wtnr	齋
whf	齌
wrrf	齌
whf	齍
wrrf	齍
whmb	齎
wrrb	齎
whre	齏
wrre	齏
wri	齐
zbu	齒
zmu	齒
zui	齒
zuo	齒
zul	齓
zuf	齔
zuvz	齕
zux	齖
zuy	齖
zuk	齗
zubr	齘
zunl	齙
zun	齙
zuvf	齚
zus	齛
zuzf	齜
zuuo	齝
zuob	齞
zum	齟
zudo	齠
zpv	齡
ztv	齡
zuap	齡
zuat	齡
zuno	齣
bnzu	齤
zuix	齥
zui	齥
zuqx	齥
zudk	齦
fdzu	齧
hdzu	齧
zulx	齩
zuoz	齪
zuot	齫
zuwo	齬
zudo	齮
zuv	齮
zugr	齯
zurd	齰
zuru	齱
zupu	齲
zulm	齴
zuwm	齴
zuqu	齵
zuok	齶
zuo	齶
zucp	齷
zubf	齸
bhiu	齹
bkpu	齹
zune	齺
zujb	齻
zutz	齼
zeou	齾
akp	龍
al	龍
lul	龍
lal	龎
llul	龎
lakp	龐
lal	龐
llul	龐
aed	龑
agn	龑
apd	龑
luld	龑
ars	龒
luls	龒
xal	龓
xlul	龓
xua	龓
xull	龓
akpb	龔
arb	龔
lulb	龔
aoa	龕
aoll	龕
uooa	龗
uool	龗
aaa	龘
lull	龘
nql	龜
nxl	龜
hnx	龝
aoom	龠
aooi	龡
aooh	龢
aoow	龣
aood	龤
aoob	龥
aoot	龥
